UBIGEO,REGIﾓN,PROVINCIA,DISTRITO,NO_NAC,SI_VIV,NO_VIV,TOTAL_PDB
010101,Amazonas,Chachapoyas,Chachapoyas,2633,22774,7182,32589
010102,Amazonas,Chachapoyas,Asunciﾃｳn,22,220,20,262
010103,Amazonas,Chachapoyas,Balsas,111,938,87,1136
010104,Amazonas,Chachapoyas,Cheto,44,533,65,642
010105,Amazonas,Chachapoyas,Chiliquin,49,483,53,585
010106,Amazonas,Chachapoyas,Chuquibamba,184,1472,125,1781
010107,Amazonas,Chachapoyas,Granada,31,423,26,480
010108,Amazonas,Chachapoyas,Huancas,31,684,543,1258
010109,Amazonas,Chachapoyas,La Jalca,408,3416,154,3978
010110,Amazonas,Chachapoyas,Leimebamba,284,2850,486,3620
010111,Amazonas,Chachapoyas,Levanto,72,648,74,794
010112,Amazonas,Chachapoyas,Magdalena,79,645,128,852
010113,Amazonas,Chachapoyas,Mariscal Castilla,113,1021,233,1367
010114,Amazonas,Chachapoyas,Molinopampa,165,1782,229,2176
010115,Amazonas,Chachapoyas,Montevideo,40,403,53,496
010116,Amazonas,Chachapoyas,Olleros,29,305,41,375
010117,Amazonas,Chachapoyas,Quinjalca,51,713,5,769
010118,Amazonas,Chachapoyas,San Francisco de Daguas,14,214,67,295
010119,Amazonas,Chachapoyas,San Isidro de Maino,48,488,44,580
010120,Amazonas,Chachapoyas,Soloco,87,1077,60,1224
010121,Amazonas,Chachapoyas,Sonche,24,206,17,247
010201,Amazonas,Bagua,Bagua,2200,21740,3162,27102
010202,Amazonas,Bagua,Aramango,986,8391,388,9765
010203,Amazonas,Bagua,Copallin,336,4079,180,4595
010204,Amazonas,Bagua,El Parco,106,1065,45,1216
010205,Amazonas,Bagua,Imaza,3587,20563,1012,25162
010206,Amazonas,Bagua,La Peca,546,5299,415,6260
010301,Amazonas,Bongara,Jumbilla,94,1047,196,1337
010302,Amazonas,Bongara,Chisquilla,31,223,52,306
010303,Amazonas,Bongara,Churuja,23,195,69,287
010304,Amazonas,Bongara,Corosha,95,586,91,772
010305,Amazonas,Bongara,Cuispes,47,569,53,669
010306,Amazonas,Bongara,Florida,540,4731,728,5999
010307,Amazonas,Bongara,Jazan,577,5761,1242,7580
010308,Amazonas,Bongara,Recta,17,172,19,208
010309,Amazonas,Bongara,San Carlos,27,440,22,489
010310,Amazonas,Bongara,Shipasbamba,146,1266,127,1539
010311,Amazonas,Bongara,Valera,65,705,104,874
010312,Amazonas,Bongara,Yambrasbamba,564,4450,563,5577
010401,Amazonas,Condorcanqui,Nieva,2823,14927,876,18626
010402,Amazonas,Condorcanqui,El Cenepa,1531,8263,97,9891
010403,Amazonas,Condorcanqui,Rio Santiago,2339,11518,96,13953
010501,Amazonas,Luya,Lamud,147,1730,350,2227
010502,Amazonas,Luya,Camporredondo,755,5244,474,6473
010503,Amazonas,Luya,Cocabamba,229,1578,74,1881
010504,Amazonas,Luya,Colcamar,158,1610,85,1853
010505,Amazonas,Luya,Conila,164,1599,77,1840
010506,Amazonas,Luya,Inguilpata,20,453,25,498
010507,Amazonas,Luya,Longuita,88,721,30,839
010508,Amazonas,Luya,Lonya Chico,62,730,50,842
010509,Amazonas,Luya,Luya,333,3229,397,3959
010510,Amazonas,Luya,Luya Viejo,45,324,19,388
010511,Amazonas,Luya,Marﾃｭa,62,628,54,744
010512,Amazonas,Luya,Ocalli,341,2877,338,3556
010513,Amazonas,Luya,Ocumal,330,2942,174,3446
010514,Amazonas,Luya,Pisuquia,495,4104,169,4768
010515,Amazonas,Luya,Providencia,121,1116,79,1316
010516,Amazonas,Luya,San Cristobal,48,471,27,546
010517,Amazonas,Luya,San Francisco del Yeso,70,565,60,695
010518,Amazonas,Luya,San Jerﾃｳnimo,43,554,36,633
010519,Amazonas,Luya,San Juan de Lopecancha,44,346,29,419
010520,Amazonas,Luya,Santa Catalina,232,1514,142,1888
010521,Amazonas,Luya,Santo Tomas,282,2513,217,3012
010522,Amazonas,Luya,Tingo,123,981,161,1265
010523,Amazonas,Luya,Trita,133,1112,103,1348
010601,Amazonas,Rodrﾃｭguez de Mendoza,San Nicolﾃ｡s,462,4277,1277,6016
010602,Amazonas,Rodrﾃｭguez de Mendoza,Chirimoto,305,1919,274,2498
010603,Amazonas,Rodrﾃｭguez de Mendoza,Cochamal,50,498,47,595
010604,Amazonas,Rodrﾃｭguez de Mendoza,Huambo,134,2334,152,2620
010605,Amazonas,Rodrﾃｭguez de Mendoza,Limabamba,189,1964,127,2280
010606,Amazonas,Rodrﾃｭguez de Mendoza,Longar,122,1285,224,1631
010607,Amazonas,Rodrﾃｭguez de Mendoza,Mariscal Benavides,116,1167,223,1506
010608,Amazonas,Rodrﾃｭguez de Mendoza,Milpuc,30,387,36,453
010609,Amazonas,Rodrﾃｭguez de Mendoza,Omia,1010,6925,858,8793
010610,Amazonas,Rodrﾃｭguez de Mendoza,Santa Rosa,37,434,41,512
010611,Amazonas,Rodrﾃｭguez de Mendoza,Totora,17,257,8,282
010612,Amazonas,Rodrﾃｭguez de Mendoza,Vista Alegre,392,2169,251,2812
010701,Amazonas,Utcubamba,Bagua Grande,4810,40854,5177,50841
010702,Amazonas,Utcubamba,Cajaruro,2107,20099,883,23089
010703,Amazonas,Utcubamba,Cumba,796,6646,413,7855
010704,Amazonas,Utcubamba,El Milagro,595,4394,836,5825
010705,Amazonas,Utcubamba,Jamalca,682,5587,351,6620
010706,Amazonas,Utcubamba,Lonya Grande,1031,8241,808,10080
010707,Amazonas,Utcubamba,Yamon,273,2442,212,2927
020101,ﾃ］cash,Huaraz,Huaraz,5087,48372,7437,60896
020102,ﾃ］cash,Huaraz,Cochabamba,164,1438,37,1639
020103,ﾃ］cash,Huaraz,Colcabamba,29,239,26,294
020104,ﾃ］cash,Huaraz,Huanchay,106,1438,56,1600
020105,ﾃ］cash,Huaraz,Independencia,6792,60413,8883,76088
020106,ﾃ］cash,Huaraz,Jangas,408,4016,357,4781
020107,ﾃ］cash,Huaraz,La Libertad,123,921,22,1066
020108,ﾃ］cash,Huaraz,Olleros,188,2012,151,2351
020109,ﾃ］cash,Huaraz,Pampas Grande,73,858,25,956
020110,ﾃ］cash,Huaraz,Pariacoto,398,3975,233,4606
020111,ﾃ］cash,Huaraz,Pira,295,2851,175,3321
020112,ﾃ］cash,Huaraz,Tarica,560,5381,397,6338
020201,ﾃ］cash,Aija,Aija,123,1723,171,2017
020202,ﾃ］cash,Aija,Coris,136,1450,53,1639
020203,ﾃ］cash,Aija,Huacllan,37,306,21,364
020204,ﾃ］cash,Aija,La Merced,128,1401,53,1582
020205,ﾃ］cash,Aija,Succha,54,611,49,714
020301,ﾃ］cash,Antonio Raymondi,Llamellin,292,2734,262,3288
020302,ﾃ］cash,Antonio Raymondi,Aczo,190,1625,103,1918
020303,ﾃ］cash,Antonio Raymondi,Chaccho,128,1179,61,1368
020304,ﾃ］cash,Antonio Raymondi,Chingas,177,1525,149,1851
020305,ﾃ］cash,Antonio Raymondi,Mirgas,476,3542,49,4067
020306,ﾃ］cash,Antonio Raymondi,San Juan de Rontoy,122,1013,23,1158
020401,ﾃ］cash,Asunciﾃｳn,Chacas,362,3831,370,4563
020402,ﾃ］cash,Asunciﾃｳn,Acochaca,229,2501,85,2815
020501,ﾃ］cash,Bolognesi,Chiquian,259,3312,452,4023
020502,ﾃ］cash,Bolognesi,Abelardo Pardo Lezameta,18,205,21,244
020503,ﾃ］cash,Bolognesi,Antonio Raymondi,61,866,67,994
020504,ﾃ］cash,Bolognesi,Aquia,178,1668,216,2062
020505,ﾃ］cash,Bolognesi,Cajacay,138,1393,146,1677
020506,ﾃ］cash,Bolognesi,Canis,21,256,35,312
020507,ﾃ］cash,Bolognesi,Colquioc,156,1871,286,2313
020508,ﾃ］cash,Bolognesi,Huallanca,576,5266,626,6468
020509,ﾃ］cash,Bolognesi,Huasta,117,1217,98,1432
020510,ﾃ］cash,Bolognesi,Huayllacayan,81,1132,40,1253
020511,ﾃ］cash,Bolognesi,La Primavera,28,422,7,457
020512,ﾃ］cash,Bolognesi,Mangas,23,386,83,492
020513,ﾃ］cash,Bolognesi,Pacllon,64,734,119,917
020514,ﾃ］cash,Bolognesi,San Miguel de Corpanqui,32,436,27,495
020515,ﾃ］cash,Bolognesi,Ticllos,40,547,71,658
020601,ﾃ］cash,Carhuaz,Carhuaz,1355,12776,991,15122
020602,ﾃ］cash,Carhuaz,Acopampa,204,2126,142,2472
020603,ﾃ］cash,Carhuaz,Amashca,98,1306,27,1431
020604,ﾃ］cash,Carhuaz,Anta,221,2055,89,2365
020605,ﾃ］cash,Carhuaz,Ataquero,111,1327,31,1469
020606,ﾃ］cash,Carhuaz,Marcara,752,8434,292,9478
020607,ﾃ］cash,Carhuaz,Pariahuanca,141,1188,52,1381
020608,ﾃ］cash,Carhuaz,San Miguel de Aco,230,2085,35,2350
020609,ﾃ］cash,Carhuaz,Shilla,206,2488,95,2789
020610,ﾃ］cash,Carhuaz,Tinco,281,2773,281,3335
020611,ﾃ］cash,Carhuaz,Yungar,273,2619,100,2992
020701,ﾃ］cash,Carlos Fermﾃｭn Fitzcarrald,San Luis,906,9145,442,10493
020702,ﾃ］cash,Carlos Fermﾃｭn Fitzcarrald,San Nicolﾃ｡s,305,2782,44,3131
020703,ﾃ］cash,Carlos Fermﾃｭn Fitzcarrald,Yauya,390,3602,101,4093
020801,ﾃ］cash,Casma,Casma,3193,29357,3215,35765
020802,ﾃ］cash,Casma,Buena Vista Alta,477,4049,305,4831
020803,ﾃ］cash,Casma,Comandante Noel,188,1763,137,2088
020804,ﾃ］cash,Casma,Yautan,849,7013,443,8305
020901,ﾃ］cash,Corongo,Corongo,114,1446,117,1677
020902,ﾃ］cash,Corongo,Aco,29,327,23,379
020903,ﾃ］cash,Corongo,Bambas,56,357,32,445
020904,ﾃ］cash,Corongo,Cusca,277,2299,102,2678
020905,ﾃ］cash,Corongo,La Pampa,66,799,161,1026
020906,ﾃ］cash,Corongo,Yanac,52,540,42,634
020907,ﾃ］cash,Corongo,Yupan,39,341,313,693
021001,ﾃ］cash,Huari,Huari,855,7585,738,9178
021002,ﾃ］cash,Huari,Anra,95,1225,42,1362
021003,ﾃ］cash,Huari,Cajay,249,2265,59,2573
021004,ﾃ］cash,Huari,Chavin de Huantar,771,6811,389,7971
021005,ﾃ］cash,Huari,Huacachi,153,1585,44,1782
021006,ﾃ］cash,Huari,Huacchis,109,1236,82,1427
021007,ﾃ］cash,Huari,Huachis,349,2856,102,3307
021008,ﾃ］cash,Huari,Huantar,216,2296,59,2571
021009,ﾃ］cash,Huari,Masin,115,1154,92,1361
021010,ﾃ］cash,Huari,Paucas,136,1344,81,1561
021011,ﾃ］cash,Huari,Ponto,215,2325,102,2642
021012,ﾃ］cash,Huari,Rahuapampa,60,560,85,705
021013,ﾃ］cash,Huari,Rapayan,105,1241,60,1406
021014,ﾃ］cash,Huari,San Marcos,1240,12093,3700,17033
021015,ﾃ］cash,Huari,San Pedro de Chana,329,2091,114,2534
021016,ﾃ］cash,Huari,Uco,95,1106,100,1301
021101,ﾃ］cash,Huarmey,Huarmey,2257,20335,2525,25117
021102,ﾃ］cash,Huarmey,Cochapeti,58,678,4,740
021103,ﾃ］cash,Huarmey,Culebras,297,2425,375,3097
021104,ﾃ］cash,Huarmey,Huayan,45,768,48,861
021105,ﾃ］cash,Huarmey,Malvas,39,662,44,745
021201,ﾃ］cash,Huaylas,Caraz,2236,20178,1714,24128
021202,ﾃ］cash,Huaylas,Huallanca,72,739,149,960
021203,ﾃ］cash,Huaylas,Huata,114,1174,56,1344
021204,ﾃ］cash,Huaylas,Huaylas,127,1426,61,1614
021205,ﾃ］cash,Huaylas,Mato,174,1578,97,1849
021206,ﾃ］cash,Huaylas,Pamparomas,746,6894,164,7804
021207,ﾃ］cash,Huaylas,Pueblo Libre,545,5663,163,6371
021208,ﾃ］cash,Huaylas,Santa Cruz,361,3776,92,4229
021209,ﾃ］cash,Huaylas,Santo Toribio,88,924,43,1055
021210,ﾃ］cash,Huaylas,Yuracmarca,222,1676,82,1980
021301,ﾃ］cash,Mariscal Luzuriaga,Piscobamba,257,2550,217,3024
021302,ﾃ］cash,Mariscal Luzuriaga,Casca,331,3294,43,3668
021303,ﾃ］cash,Mariscal Luzuriaga,Eleazar Guzmﾃ｡n Barron,102,1194,30,1326
021304,ﾃ］cash,Mariscal Luzuriaga,Fidel Olivas Escudero,185,1700,23,1908
021305,ﾃ］cash,Mariscal Luzuriaga,Llama,70,921,29,1020
021306,ﾃ］cash,Mariscal Luzuriaga,Llumpa,592,4925,112,5629
021307,ﾃ］cash,Mariscal Luzuriaga,Lucma,221,2473,38,2732
021308,ﾃ］cash,Mariscal Luzuriaga,Musga,70,839,68,977
021401,ﾃ］cash,Ocros,Ocros,96,1011,96,1203
021402,ﾃ］cash,Ocros,Acas,52,556,48,656
021403,ﾃ］cash,Ocros,Cajamarquilla,10,286,4,300
021404,ﾃ］cash,Ocros,Carhuapampa,23,418,31,472
021405,ﾃ］cash,Ocros,Cochas,138,1114,169,1421
021406,ﾃ］cash,Ocros,Congas,109,1051,59,1219
021407,ﾃ］cash,Ocros,Llipa,15,218,46,279
021408,ﾃ］cash,Ocros,San Cristﾃｳbal de Rajan,24,386,28,438
021409,ﾃ］cash,Ocros,San Pedro,48,477,97,622
021410,ﾃ］cash,Ocros,Santiago de Chilcas,29,299,101,429
021501,ﾃ］cash,Pallasca,Cabana,257,2012,176,2445
021502,ﾃ］cash,Pallasca,Bolognesi,102,834,50,986
021503,ﾃ］cash,Pallasca,Conchucos,842,6310,239,7391
021504,ﾃ］cash,Pallasca,Huacaschuque,58,445,20,523
021505,ﾃ］cash,Pallasca,Huandoval,87,851,63,1001
021506,ﾃ］cash,Pallasca,Lacabamba,51,426,28,505
021507,ﾃ］cash,Pallasca,Llapo,45,494,58,597
021508,ﾃ］cash,Pallasca,Pallasca,202,2021,141,2364
021509,ﾃ］cash,Pallasca,Pampas,370,3475,135,3980
021510,ﾃ］cash,Pallasca,Santa Rosa,79,852,95,1026
021511,ﾃ］cash,Pallasca,Tauca,208,2343,122,2673
021601,ﾃ］cash,Pomabamba,Pomabamba,1272,11873,689,13834
021602,ﾃ］cash,Pomabamba,Huayllan,255,2595,104,2954
021603,ﾃ］cash,Pomabamba,Parobamba,506,5200,100,5806
021604,ﾃ］cash,Pomabamba,Quinuabamba,186,1993,21,2200
021701,ﾃ］cash,Recuay,Recuay,369,3694,343,4406
021702,ﾃ］cash,Recuay,Catac,346,3310,251,3907
021703,ﾃ］cash,Recuay,Cotaparaco,33,357,19,409
021704,ﾃ］cash,Recuay,Huayllapampa,31,561,28,620
021705,ﾃ］cash,Recuay,Llacllin,62,791,59,912
021706,ﾃ］cash,Recuay,Marca,48,1501,59,1608
021707,ﾃ］cash,Recuay,Pampas Chico,64,827,32,923
021708,ﾃ］cash,Recuay,Pararin,106,1321,90,1517
021709,ﾃ］cash,Recuay,Tapacocha,31,367,23,421
021710,ﾃ］cash,Recuay,Ticapampa,240,2024,198,2462
021801,ﾃ］cash,Santa,Chimbote,15563,178798,11852,206213
021802,ﾃ］cash,Santa,Cﾃ｡ceres del Perﾃｺ,414,3823,183,4420
021803,ﾃ］cash,Santa,Coishco,1408,13597,974,15979
021804,ﾃ］cash,Santa,Macate,270,2782,73,3125
021805,ﾃ］cash,Santa,Moro,776,6853,405,8034
021806,ﾃ］cash,Santa,Nepeﾃｱa,1272,11995,1057,14324
021807,ﾃ］cash,Santa,Samanco,452,3900,418,4770
021808,ﾃ］cash,Santa,Santa,1754,16542,1325,19621
021809,ﾃ］cash,Santa,Nuevo Chimbote,14096,124560,20665,159321
021901,ﾃ］cash,Sihuas,Sihuas,469,4375,567,5411
021902,ﾃ］cash,Sihuas,Acobamba,186,1390,36,1612
021903,ﾃ］cash,Sihuas,Alfonso Ugarte,31,478,24,533
021904,ﾃ］cash,Sihuas,Cashapampa,264,2403,72,2739
021905,ﾃ］cash,Sihuas,Chingalpo,91,786,28,905
021906,ﾃ］cash,Sihuas,Huayllabamba,358,3093,67,3518
021907,ﾃ］cash,Sihuas,Quiches,184,2080,42,2306
021908,ﾃ］cash,Sihuas,Ragash,212,2034,32,2278
021909,ﾃ］cash,Sihuas,San Juan,666,5463,58,6187
021910,ﾃ］cash,Sihuas,Sicsibamba,116,1336,30,1482
022001,ﾃ］cash,Yungay,Yungay,1616,17107,1347,20070
022002,ﾃ］cash,Yungay,Cascapara,141,1499,34,1674
022003,ﾃ］cash,Yungay,Mancos,492,5516,328,6336
022004,ﾃ］cash,Yungay,Matacoto,117,1169,57,1343
022005,ﾃ］cash,Yungay,Quillo,1161,10375,93,11629
022006,ﾃ］cash,Yungay,Ranrahirca,193,2330,134,2657
022007,ﾃ］cash,Yungay,Shupluy,206,1623,11,1840
022008,ﾃ］cash,Yungay,Yanama,489,4714,89,5292
030101,Apurﾃｭmac,Abancay,Abancay,6159,51277,11592,69028
030102,Apurﾃｭmac,Abancay,Chacoche,115,1081,143,1339
030103,Apurﾃｭmac,Abancay,Circa,111,1657,98,1866
030104,Apurﾃｭmac,Abancay,Curahuasi,1363,13473,1387,16223
030105,Apurﾃｭmac,Abancay,Huanipaca,198,2619,69,2886
030106,Apurﾃｭmac,Abancay,Lambrama,181,2605,216,3002
030107,Apurﾃｭmac,Abancay,Pichirhua,170,2456,148,2774
030108,Apurﾃｭmac,Abancay,San Pedro de Cachora,168,2228,145,2541
030109,Apurﾃｭmac,Abancay,Tamburco,964,7467,2430,10861
030201,Apurﾃｭmac,Andahuaylas,Andahuaylas,4054,32522,5692,42268
030202,Apurﾃｭmac,Andahuaylas,Andarapa,467,4899,93,5459
030203,Apurﾃｭmac,Andahuaylas,Chiara,90,1026,70,1186
030204,Apurﾃｭmac,Andahuaylas,Huancarama,372,4511,327,5210
030205,Apurﾃｭmac,Andahuaylas,Huancaray,321,3349,83,3753
030206,Apurﾃｭmac,Andahuaylas,Huayana,58,668,24,750
030207,Apurﾃｭmac,Andahuaylas,Kishuara,621,5179,223,6023
030208,Apurﾃｭmac,Andahuaylas,Pacobamba,261,3082,109,3452
030209,Apurﾃｭmac,Andahuaylas,Pacucha,539,7165,285,7989
030210,Apurﾃｭmac,Andahuaylas,Pampachiri,213,1877,109,2199
030211,Apurﾃｭmac,Andahuaylas,Pomacocha,75,738,50,863
030212,Apurﾃｭmac,Andahuaylas,San Antonio de Cachi,256,2581,73,2910
030213,Apurﾃｭmac,Andahuaylas,San Jerﾃｳnimo,1998,16992,1748,20738
030214,Apurﾃｭmac,Andahuaylas,San Miguel de Chaccrampa,168,1404,41,1613
030215,Apurﾃｭmac,Andahuaylas,Santa Marﾃｭa de Chicmo,821,7147,184,8152
030216,Apurﾃｭmac,Andahuaylas,Talavera,1724,15114,1671,18509
030217,Apurﾃｭmac,Andahuaylas,Tumay Huaraca,175,1670,19,1864
030218,Apurﾃｭmac,Andahuaylas,Turpo,280,3276,86,3642
030219,Apurﾃｭmac,Andahuaylas,Kaquiabamba,113,1659,44,1816
030220,Apurﾃｭmac,Andahuaylas,Josﾃｩ Marﾃｭa Arguedas,461,3428,192,4081
030301,Apurﾃｭmac,Antabamba,Antabamba,193,2362,221,2776
030302,Apurﾃｭmac,Antabamba,El Oro,45,458,49,552
030303,Apurﾃｭmac,Antabamba,Huaquirca,114,1368,359,1841
030304,Apurﾃｭmac,Antabamba,Juan Espinoza Medrano,123,1490,98,1711
030305,Apurﾃｭmac,Antabamba,Oropesa,202,1954,112,2268
030306,Apurﾃｭmac,Antabamba,Pachaconas,86,911,57,1054
030307,Apurﾃｭmac,Antabamba,Sabaino,64,1006,38,1108
030401,Apurﾃｭmac,Aymaraes,Chalhuanca,410,3334,1184,4928
030402,Apurﾃｭmac,Aymaraes,Capaya,46,486,48,580
030403,Apurﾃｭmac,Aymaraes,Caraybamba,61,827,41,929
030404,Apurﾃｭmac,Aymaraes,Chapimarca,145,1612,136,1893
030405,Apurﾃｭmac,Aymaraes,Colcabamba,51,599,43,693
030406,Apurﾃｭmac,Aymaraes,Cotaruse,197,2030,343,2570
030407,Apurﾃｭmac,Aymaraes,Ihuayllo,22,386,54,462
030408,Apurﾃｭmac,Aymaraes,Justo Apu Sahuaraura,56,628,51,735
030409,Apurﾃｭmac,Aymaraes,Lucre,143,1327,59,1529
030410,Apurﾃｭmac,Aymaraes,Pocohuanca,68,889,65,1022
030411,Apurﾃｭmac,Aymaraes,San Juan de Chacﾃｱa,52,651,66,769
030412,Apurﾃｭmac,Aymaraes,Saﾃｱayca,70,975,62,1107
030413,Apurﾃｭmac,Aymaraes,Soraya,49,602,60,711
030414,Apurﾃｭmac,Aymaraes,Tapairihua,147,1647,54,1848
030415,Apurﾃｭmac,Aymaraes,Tintay,161,1927,184,2272
030416,Apurﾃｭmac,Aymaraes,Toraya,82,1099,97,1278
030417,Apurﾃｭmac,Aymaraes,Yanaca,60,834,87,981
030501,Apurﾃｭmac,Cotabambas,Tambobamba,1060,8478,843,10381
030502,Apurﾃｭmac,Cotabambas,Cotabambas,297,3210,379,3886
030503,Apurﾃｭmac,Cotabambas,Coyllurqui,642,5723,221,6586
030504,Apurﾃｭmac,Cotabambas,Haquira,733,8086,611,9430
030505,Apurﾃｭmac,Cotabambas,Mara,546,5076,226,5848
030506,Apurﾃｭmac,Cotabambas,Challhuahuacho,1380,9343,3802,14525
030601,Apurﾃｭmac,Chincheros,Chincheros,528,4178,587,5293
030602,Apurﾃｭmac,Chincheros,Anco_Huallo,993,8367,1028,10388
030603,Apurﾃｭmac,Chincheros,Cocharcas,158,1493,77,1728
030604,Apurﾃｭmac,Chincheros,Huaccana,576,5773,285,6634
030605,Apurﾃｭmac,Chincheros,Ocobamba,636,5887,236,6759
030606,Apurﾃｭmac,Chincheros,Ongoy,197,2042,105,2344
030607,Apurﾃｭmac,Chincheros,Uranmarca,264,2295,91,2650
030608,Apurﾃｭmac,Chincheros,Ranracancha,388,3515,143,4046
030609,Apurﾃｭmac,Chincheros,Rocchacc,259,2324,106,2689
030610,Apurﾃｭmac,Chincheros,El Porvenir,163,1493,72,1728
030611,Apurﾃｭmac,Chincheros,Los Chankas,103,776,109,988
030701,Apurﾃｭmac,Grau,Chuquibambilla,330,4335,358,5023
030702,Apurﾃｭmac,Grau,Curpahuasi,153,1710,73,1936
030703,Apurﾃｭmac,Grau,Gamarra,163,2552,67,2782
030704,Apurﾃｭmac,Grau,Huayllati,117,1222,29,1368
030705,Apurﾃｭmac,Grau,Mamara,48,752,58,858
030706,Apurﾃｭmac,Grau,Micaela Bastidas,58,828,49,935
030707,Apurﾃｭmac,Grau,Pataypampa,57,719,22,798
030708,Apurﾃｭmac,Grau,Progreso,337,2400,208,2945
030709,Apurﾃｭmac,Grau,San Antonio,19,232,21,272
030710,Apurﾃｭmac,Grau,Santa Rosa,32,508,20,560
030711,Apurﾃｭmac,Grau,Turpay,38,551,39,628
030712,Apurﾃｭmac,Grau,Vilcabamba,103,880,250,1233
030713,Apurﾃｭmac,Grau,Virundo,49,602,24,675
030714,Apurﾃｭmac,Grau,Curasco,107,1071,51,1229
040101,Arequipa,Arequipa,Arequipa,2723,38976,13738,55437
040102,Arequipa,Arequipa,Alto Selva Alegre,6534,65235,14101,85870
040103,Arequipa,Arequipa,Cayma,7389,67982,16564,91935
040104,Arequipa,Arequipa,Cerro Colorado,18348,138087,41519,197954
040105,Arequipa,Arequipa,Characato,1162,8196,3591,12949
040106,Arequipa,Arequipa,Chiguata,254,2232,453,2939
040107,Arequipa,Arequipa,Jacobo Hunter,3919,39469,6776,50164
040108,Arequipa,Arequipa,La Joya,2958,23678,5383,32019
040109,Arequipa,Arequipa,Mariano Melgar,4424,46138,9356,59918
040110,Arequipa,Arequipa,Miraflores,4451,44218,11920,60589
040111,Arequipa,Arequipa,Mollebaya,488,2834,1434,4756
040112,Arequipa,Arequipa,Paucarpata,9667,104951,16728,131346
040113,Arequipa,Arequipa,Pocsi,12,390,43,445
040114,Arequipa,Arequipa,Polobaya,43,743,51,837
040115,Arequipa,Arequipa,Quequeﾃｱa,441,2660,1683,4784
040116,Arequipa,Arequipa,Sabandia,325,3338,705,4368
040117,Arequipa,Arequipa,Sachaca,1997,17502,4726,24225
040118,Arequipa,Arequipa,San Juan de Siguas,45,485,81,611
040119,Arequipa,Arequipa,San Juan de Tarucani,80,1206,91,1377
040120,Arequipa,Arequipa,Santa Isabel de Siguas,46,532,104,682
040121,Arequipa,Arequipa,Santa Rita de Siguas,666,5078,574,6318
040122,Arequipa,Arequipa,Socabaya,5645,55634,14072,75351
040123,Arequipa,Arequipa,Tiabaya,1331,13012,1848,16191
040124,Arequipa,Arequipa,Uchumayo,1228,10819,2007,14054
040125,Arequipa,Arequipa,Vitor,268,2849,493,3610
040126,Arequipa,Arequipa,Yanahuara,1284,17758,6375,25417
040127,Arequipa,Arequipa,Yarabamba,91,915,308,1314
040128,Arequipa,Arequipa,Yura,3360,21413,8573,33346
040129,Arequipa,Arequipa,Josﾃｩ Luis Bustamante Y Rivero,5159,60966,15704,81829
040201,Arequipa,Camanﾃ｡,Camanﾃ｡,839,10348,2180,13367
040202,Arequipa,Camanﾃ｡,Josﾃｩ Marﾃｭa Quimper,455,3544,642,4641
040203,Arequipa,Camanﾃ｡,Mariano Nicolﾃ｡s Valcﾃ｡rcel,874,3162,2961,6997
040204,Arequipa,Camanﾃ｡,Mariscal Cﾃ｡ceres,491,4690,1014,6195
040205,Arequipa,Camanﾃ｡,Nicolﾃ｡s de Pierola,580,5648,878,7106
040206,Arequipa,Camanﾃ｡,Ocoﾃｱa,343,3318,510,4171
040207,Arequipa,Camanﾃ｡,Quilca,95,679,169,943
040208,Arequipa,Camanﾃ｡,Samuel Pastor,1400,12134,2416,15950
040301,Arequipa,Caravelﾃｭ,Caravelﾃｭ,354,2880,1025,4259
040302,Arequipa,Caravelﾃｭ,Acarﾃｭ,382,3707,834,4923
040303,Arequipa,Caravelﾃｭ,Atico,467,3797,951,5215
040304,Arequipa,Caravelﾃｭ,Atiquipa,39,387,47,473
040305,Arequipa,Caravelﾃｭ,Bella Uniﾃｳn,232,2460,479,3171
040306,Arequipa,Caravelﾃｭ,Cahuacho,49,508,53,610
040307,Arequipa,Caravelﾃｭ,Chala,831,5929,2480,9240
040308,Arequipa,Caravelﾃｭ,Chaparra,312,2314,1059,3685
040309,Arequipa,Caravelﾃｭ,Huanuhuanu,298,1886,863,3047
040310,Arequipa,Caravelﾃｭ,Jaqui,137,1207,188,1532
040311,Arequipa,Caravelﾃｭ,Lomas,134,1071,272,1477
040312,Arequipa,Caravelﾃｭ,Quicacha,167,1445,225,1837
040313,Arequipa,Caravelﾃｭ,Yauca,150,1410,317,1877
040401,Arequipa,Castilla,Aplao,634,6939,862,8435
040402,Arequipa,Castilla,Andagua,65,778,195,1038
040403,Arequipa,Castilla,Ayo,7,189,46,242
040404,Arequipa,Castilla,Chachas,135,1293,218,1646
040405,Arequipa,Castilla,Chilcaymarca,101,771,75,947
040406,Arequipa,Castilla,Choco,48,600,54,702
040407,Arequipa,Castilla,Huancarqui,101,1154,217,1472
040408,Arequipa,Castilla,Machaguay,21,411,56,488
040409,Arequipa,Castilla,Orcopampa,843,5946,1388,8177
040410,Arequipa,Castilla,Pampacolca,145,1710,177,2032
040411,Arequipa,Castilla,Tipan,32,350,50,432
040412,Arequipa,Castilla,Uﾃｱon,13,136,58,207
040413,Arequipa,Castilla,Uraca,479,5053,734,6266
040414,Arequipa,Castilla,Viraco,97,1176,272,1545
040501,Arequipa,Caylloma,Chivay,545,4463,762,5770
040502,Arequipa,Caylloma,Achoma,58,703,80,841
040503,Arequipa,Caylloma,Cabanaconde,135,1742,219,2096
040504,Arequipa,Caylloma,Callalli,89,1269,100,1458
040505,Arequipa,Caylloma,Caylloma,196,2740,761,3697
040506,Arequipa,Caylloma,Coporaque,82,820,187,1089
040507,Arequipa,Caylloma,Huambo,53,558,59,670
040508,Arequipa,Caylloma,Huanca,64,891,55,1010
040509,Arequipa,Caylloma,Ichupampa,36,470,49,555
040510,Arequipa,Caylloma,Lari,70,783,51,904
040511,Arequipa,Caylloma,Lluta,41,625,52,718
040512,Arequipa,Caylloma,Maca,35,598,68,701
040513,Arequipa,Caylloma,Madrigal,38,544,66,648
040514,Arequipa,Caylloma,San Antonio de Chuca,77,739,70,886
040515,Arequipa,Caylloma,Sibayo,42,550,77,669
040516,Arequipa,Caylloma,Tapay,42,405,325,772
040517,Arequipa,Caylloma,Tisco,106,1188,147,1441
040518,Arequipa,Caylloma,Tuti,40,552,29,621
040519,Arequipa,Caylloma,Yanque,171,1748,198,2117
040520,Arequipa,Caylloma,Majes,5946,45309,8853,60108
040601,Arequipa,Condesuyos,Chuquibamba,256,2594,440,3290
040602,Arequipa,Condesuyos,Andaray,25,373,279,677
040603,Arequipa,Condesuyos,Cayarani,218,2297,697,3212
040604,Arequipa,Condesuyos,Chichas,36,502,137,675
040605,Arequipa,Condesuyos,Iray,37,485,73,595
040606,Arequipa,Condesuyos,Rﾃｭo Grande,260,2497,506,3263
040607,Arequipa,Condesuyos,Salamanca,32,424,22,478
040608,Arequipa,Condesuyos,Yanaquihua,333,2890,705,3928
040701,Arequipa,Islay,Mollendo,1755,19401,2917,24073
040702,Arequipa,Islay,Cocachacra,606,7020,721,8347
040703,Arequipa,Islay,Dean Valdivia,511,5547,796,6854
040704,Arequipa,Islay,Islay,483,3860,789,5132
040705,Arequipa,Islay,Mejia,71,752,349,1172
040706,Arequipa,Islay,Punta de Bombﾃｳn,446,5393,617,6456
040801,Arequipa,La Uniﾃｳn,Cotahuasi,241,2125,559,2925
040802,Arequipa,La Uniﾃｳn,Alca,183,1492,174,1849
040803,Arequipa,La Uniﾃｳn,Charcana,63,432,82,577
040804,Arequipa,La Uniﾃｳn,Huaynacotas,169,1614,130,1913
040805,Arequipa,La Uniﾃｳn,Pampamarca,93,984,45,1122
040806,Arequipa,La Uniﾃｳn,Puyca,242,2020,80,2342
040807,Arequipa,La Uniﾃｳn,Quechualla,14,216,35,265
040808,Arequipa,La Uniﾃｳn,Sayla,28,257,34,319
040809,Arequipa,La Uniﾃｳn,Tauria,32,221,48,301
040810,Arequipa,La Uniﾃｳn,Tomepampa,50,564,44,658
040811,Arequipa,La Uniﾃｳn,Toro,33,490,33,556
050101,Ayacucho,Huamanga,Ayacucho,8381,77289,13757,99427
050102,Ayacucho,Huamanga,Acocro,888,6335,180,7403
050103,Ayacucho,Huamanga,Acos Vinchos,458,3857,68,4383
050104,Ayacucho,Huamanga,Carmen Alto,2840,20033,5379,28252
050105,Ayacucho,Huamanga,Chiara,610,4854,234,5698
050106,Ayacucho,Huamanga,Ocros,454,4764,155,5373
050107,Ayacucho,Huamanga,Pacaycasa,303,2629,182,3114
050108,Ayacucho,Huamanga,Quinua,400,4481,202,5083
050109,Ayacucho,Huamanga,San Josﾃｩ de Ticllas,126,1257,20,1403
050110,Ayacucho,Huamanga,San Juan Bautista,4477,36174,8383,49034
050111,Ayacucho,Huamanga,Santiago de Pischa,103,1279,45,1427
050112,Ayacucho,Huamanga,Socos,525,5303,124,5952
050113,Ayacucho,Huamanga,Tambillo,589,4236,222,5047
050114,Ayacucho,Huamanga,Vinchos,1335,12116,183,13634
050115,Ayacucho,Huamanga,Jesﾃｺs Nazareno,1593,13528,3371,18492
050116,Ayacucho,Huamanga,Andrﾃｩs Avelino Cﾃ｡ceres Dorregaray,2263,19186,7023,28472
050201,Ayacucho,Cangallo,Cangallo,438,4701,340,5479
050202,Ayacucho,Cangallo,Chuschi,701,6910,710,8321
050203,Ayacucho,Cangallo,Los Morochucos,702,6486,275,7463
050204,Ayacucho,Cangallo,Marﾃｭa Parado de Bellido,163,1849,55,2067
050205,Ayacucho,Cangallo,Paras,392,3596,116,4104
050206,Ayacucho,Cangallo,Totos,234,2702,73,3009
050301,Ayacucho,Huanca Sancos,Sancos,223,2553,426,3202
050302,Ayacucho,Huanca Sancos,Carapo,101,1645,80,1826
050303,Ayacucho,Huanca Sancos,Sacsamarca,80,1193,40,1313
050304,Ayacucho,Huanca Sancos,Santiago de Lucanamarca,165,1852,51,2068
050401,Ayacucho,Huanta,Huanta,3475,31613,4429,39517
050402,Ayacucho,Huanta,Ayahuanco,100,1049,47,1196
050403,Ayacucho,Huanta,Huamanguilla,281,3685,196,4162
050404,Ayacucho,Huanta,Iguain,225,2313,129,2667
050405,Ayacucho,Huanta,Luricocha,443,4700,347,5490
050406,Ayacucho,Huanta,Santillana,340,3369,143,3852
050407,Ayacucho,Huanta,Sivia,1150,8824,823,10797
050408,Ayacucho,Huanta,Llochegua,1209,7463,1386,10058
050409,Ayacucho,Huanta,Canayre,446,2498,576,3520
050410,Ayacucho,Huanta,Uchuraccay,416,3021,85,3522
050411,Ayacucho,Huanta,Pucacolpa,279,2125,119,2523
050412,Ayacucho,Huanta,Chaca,237,259,1666,2162
050501,Ayacucho,La Mar,San Miguel,822,8883,621,10326
050502,Ayacucho,La Mar,Anco,711,6806,452,7969
050503,Ayacucho,La Mar,Ayna,751,7559,988,9298
050504,Ayacucho,La Mar,Chilcas,125,1474,44,1643
050505,Ayacucho,La Mar,Chungui,424,3661,133,4218
050506,Ayacucho,La Mar,Luis Carranza,118,1144,16,1278
050507,Ayacucho,La Mar,Santa Rosa,1264,9025,990,11279
050508,Ayacucho,La Mar,Tambo,1035,8830,308,10173
050509,Ayacucho,La Mar,Samugari,990,7687,733,9410
050510,Ayacucho,La Mar,Anchihuay,459,140,3440,4039
050511,Ayacucho,La Mar,Oronccoy,94,892,34,1020
050601,Ayacucho,Lucanas,Puquio,1240,11089,1590,13919
050602,Ayacucho,Lucanas,Aucara,146,2563,194,2903
050603,Ayacucho,Lucanas,Cabana,113,1825,251,2189
050604,Ayacucho,Lucanas,Carmen Salcedo,126,1337,218,1681
050605,Ayacucho,Lucanas,Chaviﾃｱa,151,1785,227,2163
050606,Ayacucho,Lucanas,Chipao,175,2208,171,2554
050607,Ayacucho,Lucanas,Huac-Huas,108,1387,65,1560
050608,Ayacucho,Lucanas,Laramate,119,1361,97,1577
050609,Ayacucho,Lucanas,Leoncio Prado,65,996,33,1094
050610,Ayacucho,Lucanas,Llauta,53,766,74,893
050611,Ayacucho,Lucanas,Lucanas,211,2314,201,2726
050612,Ayacucho,Lucanas,Ocaﾃｱa,155,1829,307,2291
050613,Ayacucho,Lucanas,Otoca,155,1475,236,1866
050614,Ayacucho,Lucanas,Saisa,54,556,181,791
050615,Ayacucho,Lucanas,San Cristobal,170,1515,33,1718
050616,Ayacucho,Lucanas,San Juan,55,863,49,967
050617,Ayacucho,Lucanas,San Pedro,249,2330,74,2653
050618,Ayacucho,Lucanas,San Pedro de Palco,56,824,47,927
050619,Ayacucho,Lucanas,Sancos,401,3586,791,4778
050620,Ayacucho,Lucanas,Santa Ana de HuaycAHUACHO,40,705,51,796
050621,Ayacucho,Lucanas,Santa Lucia,99,874,309,1282
050701,Ayacucho,Parinacochas,Coracora,988,11019,1117,13124
050702,Ayacucho,Parinacochas,Chumpi,178,1846,162,2186
050703,Ayacucho,Parinacochas,Coronel Castaﾃｱeda,59,1176,487,1722
050704,Ayacucho,Parinacochas,Pacapausa,33,541,56,630
050705,Ayacucho,Parinacochas,Pullo,629,4260,1382,6271
050706,Ayacucho,Parinacochas,Puyusca,164,1791,107,2062
050707,Ayacucho,Parinacochas,San Francisco de Ravacayco,44,414,58,516
050708,Ayacucho,Parinacochas,Upahuacho,101,981,66,1148
050801,Ayacucho,Pﾃ｡ucar del Sara Sara,Pausa,254,2465,512,3231
050802,Ayacucho,Pﾃ｡ucar del Sara Sara,Colta,33,374,61,468
050803,Ayacucho,Pﾃ｡ucar del Sara Sara,Corculla,35,368,42,445
050804,Ayacucho,Pﾃ｡ucar del Sara Sara,Lampa,148,1691,114,1953
050805,Ayacucho,Pﾃ｡ucar del Sara Sara,Marcabamba,38,492,83,613
050806,Ayacucho,Pﾃ｡ucar del Sara Sara,Oyolo,99,920,434,1453
050807,Ayacucho,Pﾃ｡ucar del Sara Sara,Pararca,35,346,38,419
050808,Ayacucho,Pﾃ｡ucar del Sara Sara,San Javier de Alpabamba,24,235,33,292
050809,Ayacucho,Pﾃ｡ucar del Sara Sara,San Josﾃｩ de Ushua,16,167,38,221
050810,Ayacucho,Pﾃ｡ucar del Sara Sara,Sara Sara,29,453,32,514
050901,Ayacucho,Sucre,Querobamba,192,2074,304,2570
050902,Ayacucho,Sucre,Belﾃｩn,21,284,24,329
050903,Ayacucho,Sucre,Chalcos,36,398,44,478
050904,Ayacucho,Sucre,Chilcayoc,44,411,41,496
050905,Ayacucho,Sucre,Huacaﾃｱa,24,325,25,374
050906,Ayacucho,Sucre,Morcolla,85,1103,52,1240
050907,Ayacucho,Sucre,Paico,30,455,68,553
050908,Ayacucho,Sucre,San Pedro de Larcay,74,686,48,808
050909,Ayacucho,Sucre,San Salvador de Quije,71,870,37,978
050910,Ayacucho,Sucre,Santiago de Paucaray,33,498,63,594
050911,Ayacucho,Sucre,Soras,81,830,114,1025
051001,Ayacucho,Vﾃｭctor Fajardo,Huancapi,134,1547,206,1887
051002,Ayacucho,Vﾃｭctor Fajardo,Alcamenca,117,1377,32,1526
051003,Ayacucho,Vﾃｭctor Fajardo,Apongo,53,556,21,630
051004,Ayacucho,Vﾃｭctor Fajardo,Asquipata,16,374,70,460
051005,Ayacucho,Vﾃｭctor Fajardo,Canaria,249,3319,409,3977
051006,Ayacucho,Vﾃｭctor Fajardo,Cayara,60,1044,34,1138
051007,Ayacucho,Vﾃｭctor Fajardo,Colca,80,878,53,1011
051008,Ayacucho,Vﾃｭctor Fajardo,Huamanquiquia,117,925,47,1089
051009,Ayacucho,Vﾃｭctor Fajardo,Huancaraylla,100,1098,96,1294
051010,Ayacucho,Vﾃｭctor Fajardo,Hualla,134,1808,150,2092
051011,Ayacucho,Vﾃｭctor Fajardo,Sarhua,201,2344,71,2616
051012,Ayacucho,Vﾃｭctor Fajardo,Vilcanchos,185,2128,76,2389
051101,Ayacucho,Vilcas Huamﾃ｡n,Vilcas Huamﾃ｡n,508,5571,291,6370
051102,Ayacucho,Vilcas Huamﾃ｡n,Accomarca,60,789,37,886
051103,Ayacucho,Vilcas Huamﾃ｡n,Carhuanca,56,729,34,819
051104,Ayacucho,Vilcas Huamﾃ｡n,Concepciﾃｳn,122,1402,53,1577
051105,Ayacucho,Vilcas Huamﾃ｡n,Huambalpa,73,1218,49,1340
051106,Ayacucho,Vilcas Huamﾃ｡n,Independencia,61,1000,44,1105
051107,Ayacucho,Vilcas Huamﾃ｡n,Saurama,73,943,22,1038
051108,Ayacucho,Vilcas Huamﾃ｡n,Vischongo,324,3230,172,3726
060101,Cajamarca,Cajamarca,Cajamarca,19734,178607,20400,218741
060102,Cajamarca,Cajamarca,Asunciﾃｳn,745,7021,173,7939
060103,Cajamarca,Cajamarca,Chetilla,423,3180,57,3660
060104,Cajamarca,Cajamarca,Cospan,689,5984,87,6760
060105,Cajamarca,Cajamarca,Encaﾃｱada,1853,17085,237,19175
060106,Cajamarca,Cajamarca,Jesﾃｺs,1618,12858,544,15020
060107,Cajamarca,Cajamarca,Llacanora,616,4724,299,5639
060108,Cajamarca,Cajamarca,Los Baﾃｱos del Inca,4832,36219,5098,46149
060109,Cajamarca,Cajamarca,Magdalena,739,7126,406,8271
060110,Cajamarca,Cajamarca,Matara,285,3045,139,3469
060111,Cajamarca,Cajamarca,Namora,1095,7971,201,9267
060112,Cajamarca,Cajamarca,San Juan,418,3784,141,4343
060201,Cajamarca,Cajabamba,Cajabamba,3026,25764,2432,31222
060202,Cajamarca,Cajabamba,Cachachi,2896,19848,780,23524
060203,Cajamarca,Cajabamba,Condebamba,1385,11667,354,13406
060204,Cajamarca,Cajabamba,Sitacocha,944,6441,150,7535
060301,Cajamarca,Celendﾃｭn,Celendﾃｭn,2442,21094,3389,26925
060302,Cajamarca,Celendﾃｭn,Chumuch,244,2311,45,2600
060303,Cajamarca,Celendﾃｭn,Cortegana,767,5898,81,6746
060304,Cajamarca,Celendﾃｭn,Huasmin,928,9615,114,10657
060305,Cajamarca,Celendﾃｭn,Jorge Chﾃ｡vez,28,391,22,441
060306,Cajamarca,Celendﾃｭn,Josﾃｩ Galvez,229,2158,171,2558
060307,Cajamarca,Celendﾃｭn,Miguel Iglesias,354,3422,94,3870
060308,Cajamarca,Celendﾃｭn,Oxamarca,551,4771,72,5394
060309,Cajamarca,Celendﾃｭn,Sorochuco,608,6681,63,7352
060310,Cajamarca,Celendﾃｭn,Sucre,491,4334,230,5055
060311,Cajamarca,Celendﾃｭn,Utco,78,956,18,1052
060312,Cajamarca,Celendﾃｭn,La Libertad de Pallan,617,5733,84,6434
060401,Cajamarca,Chota,Chota,4056,40128,3095,47279
060402,Cajamarca,Chota,Anguia,272,2824,115,3211
060403,Cajamarca,Chota,Chadin,358,3006,85,3449
060404,Cajamarca,Chota,Chiguirip,297,3265,79,3641
060405,Cajamarca,Chota,Chimban,222,1903,74,2199
060406,Cajamarca,Chota,Choropampa,221,2060,55,2336
060407,Cajamarca,Chota,Cochabamba,429,4932,185,5546
060408,Cajamarca,Chota,Conchan,506,4968,169,5643
060409,Cajamarca,Chota,Huambos,655,7115,202,7972
060410,Cajamarca,Chota,Lajas,829,10016,248,11093
060411,Cajamarca,Chota,Llama,584,6226,265,7075
060412,Cajamarca,Chota,Miracosta,306,2821,76,3203
060413,Cajamarca,Chota,Paccha,395,3893,157,4445
060414,Cajamarca,Chota,Pion,119,1046,49,1214
060415,Cajamarca,Chota,Querocoto,710,7038,275,8023
060416,Cajamarca,Chota,San Juan de Licupis,82,850,26,958
060417,Cajamarca,Chota,Tacabamba,1251,14119,334,15704
060418,Cajamarca,Chota,Tocmoche,74,762,23,859
060419,Cajamarca,Chota,Chalamarca,734,8263,137,9134
060501,Cajamarca,Contumazﾃ｡,Contumazﾃ｡,708,6451,302,7461
060502,Cajamarca,Contumazﾃ｡,Chilete,193,2148,294,2635
060503,Cajamarca,Contumazﾃ｡,Cupisnique,112,1184,42,1338
060504,Cajamarca,Contumazﾃ｡,Guzmango,234,2401,44,2679
060505,Cajamarca,Contumazﾃ｡,San Benito,273,2993,133,3399
060506,Cajamarca,Contumazﾃ｡,Santa Cruz de Toled,94,877,23,994
060507,Cajamarca,Contumazﾃ｡,Tantarica,190,2168,103,2461
060508,Cajamarca,Contumazﾃ｡,Yonan,503,5823,400,6726
060601,Cajamarca,Cutervo,Cutervo,4167,44514,2224,50905
060602,Cajamarca,Cutervo,Callayuc,887,8143,331,9361
060603,Cajamarca,Cutervo,Choros,253,2526,99,2878
060604,Cajamarca,Cutervo,Cujillo,216,2052,62,2330
060605,Cajamarca,Cutervo,La Ramada,300,3260,92,3652
060606,Cajamarca,Cutervo,Pimpingos,459,4464,177,5100
060607,Cajamarca,Cutervo,Querocotillo,1194,11600,193,12987
060608,Cajamarca,Cutervo,San Andrﾃｩs de Cutervo,310,3760,102,4172
060609,Cajamarca,Cutervo,San Juan de Cutervo,150,1612,96,1858
060610,Cajamarca,Cutervo,San Luis de Lucma,223,2701,76,3000
060611,Cajamarca,Cutervo,Santa Cruz,264,2241,117,2622
060612,Cajamarca,Cutervo,Santo Domingo de la Capilla,372,4223,106,4701
060613,Cajamarca,Cutervo,Santo Tomas,573,6147,268,6988
060614,Cajamarca,Cutervo,Socota,652,8163,239,9054
060615,Cajamarca,Cutervo,Toribio Casanova,83,960,72,1115
060701,Cajamarca,Hualgayoc,Bambamarca,4781,54023,1109,59913
060702,Cajamarca,Hualgayoc,Chugur,267,2604,49,2920
060703,Cajamarca,Hualgayoc,Hualgayoc,989,13061,1061,15111
060801,Cajamarca,Jaﾃｩn,Jaﾃｩn,8368,74767,11018,94153
060802,Cajamarca,Jaﾃｩn,Bellavista,1409,12990,1048,15447
060803,Cajamarca,Jaﾃｩn,Chontali,1009,8428,373,9810
060804,Cajamarca,Jaﾃｩn,Colasay,959,8738,541,10238
060805,Cajamarca,Jaﾃｩn,Huabal,779,6580,283,7642
060806,Cajamarca,Jaﾃｩn,Las Pirias,463,3594,218,4275
060807,Cajamarca,Jaﾃｩn,Pomahuaca,831,7150,363,8344
060808,Cajamarca,Jaﾃｩn,Pucara,658,5571,605,6834
060809,Cajamarca,Jaﾃｩn,Sallique,801,6077,155,7033
060810,Cajamarca,Jaﾃｩn,San Felipe,443,4120,130,4693
060811,Cajamarca,Jaﾃｩn,San Josﾃｩ del Alto,678,5793,489,6960
060812,Cajamarca,Jaﾃｩn,Santa Rosa,842,8749,412,10003
060901,Cajamarca,San Ignacio,San Ignacio,3826,28749,2084,34659
060902,Cajamarca,San Ignacio,Chirinos,1521,12097,974,14592
060903,Cajamarca,San Ignacio,Huarango,1792,15535,685,18012
060904,Cajamarca,San Ignacio,La Coipa,2019,16623,920,19562
060905,Cajamarca,San Ignacio,Namballe,1100,7686,312,9098
060906,Cajamarca,San Ignacio,San Josﾃｩ de Lourdes,1817,14485,744,17046
060907,Cajamarca,San Ignacio,Tabaconas,2045,15110,496,17651
061001,Cajamarca,San Marcos,Pedro Gﾃ｡lvez,1775,16025,2070,19870
061002,Cajamarca,San Marcos,Chancay,290,2626,49,2965
061003,Cajamarca,San Marcos,Eduardo Villanueva,285,2159,220,2664
061004,Cajamarca,San Marcos,Gregorio Pita,400,4637,99,5136
061005,Cajamarca,San Marcos,Ichocan,151,1665,85,1901
061006,Cajamarca,San Marcos,Josﾃｩ Manuel Quiroz,318,3169,57,3544
061007,Cajamarca,San Marcos,Josﾃｩ Sabogal,1404,10500,119,12023
061101,Cajamarca,San Miguel,San Miguel,1018,11857,557,13432
061102,Cajamarca,San Miguel,Bolﾃｭvar,93,1141,85,1319
061103,Cajamarca,San Miguel,Calquis,341,3697,56,4094
061104,Cajamarca,San Miguel,Catilluc,248,2403,96,2747
061105,Cajamarca,San Miguel,El Prado,112,1477,38,1627
061106,Cajamarca,San Miguel,La Florida,128,1878,159,2165
061107,Cajamarca,San Miguel,Llapa,366,4005,110,4481
061108,Cajamarca,San Miguel,Nanchoc,91,1062,137,1290
061109,Cajamarca,San Miguel,Niepos,266,2914,113,3293
061110,Cajamarca,San Miguel,San Gregorio,167,1991,71,2229
061111,Cajamarca,San Miguel,San Silvestre de Cochan,248,3318,86,3652
061112,Cajamarca,San Miguel,Tongod,234,2367,87,2688
061113,Cajamarca,San Miguel,Uniﾃｳn Agua Blanca,215,2725,86,3026
061201,Cajamarca,San Pablo,San Pablo,1074,11035,354,12463
061202,Cajamarca,San Pablo,San Bernardino,385,3813,96,4294
061203,Cajamarca,San Pablo,San Luis,79,873,6,958
061204,Cajamarca,San Pablo,Tumbaden,329,2977,81,3387
061301,Cajamarca,Santa Cruz,Santa Cruz,756,7818,652,9226
061302,Cajamarca,Santa Cruz,Andabamba,97,1183,57,1337
061303,Cajamarca,Santa Cruz,Catache,727,7208,1023,8958
061304,Cajamarca,Santa Cruz,Chancaybaﾃｱos,287,2998,70,3355
061305,Cajamarca,Santa Cruz,La Esperanza,160,2130,31,2321
061306,Cajamarca,Santa Cruz,Ninabamba,128,1915,54,2097
061307,Cajamarca,Santa Cruz,Pulan,303,3482,111,3896
061308,Cajamarca,Santa Cruz,Saucepampa,105,1309,32,1446
061309,Cajamarca,Santa Cruz,Sexi,22,313,90,425
061310,Cajamarca,Santa Cruz,Uticyacu,104,1134,21,1259
061311,Cajamarca,Santa Cruz,Yauyucan,214,2510,120,2844
070101,Prov. Constitucional del Callao,"",Callao,33128,363537,54595,451260
070102,Prov. Constitucional del Callao,"",Bellavista,4148,59044,11659,74851
070103,Prov. Constitucional del Callao,"",Carmen de la Legua Reynoso,2897,34161,5182,42240
070104,Prov. Constitucional del Callao,"",La Perla,3431,47753,10233,61417
070105,Prov. Constitucional del Callao,"",La Punta,153,3025,651,3829
070106,Prov. Constitucional del Callao,"",Ventanilla,30662,241673,43265,315600
070107,Prov. Constitucional del Callao,"",Mi Perﾃｺ,4391,35248,5658,45297
080101,Cusco,Cusco,Cusco,8577,82371,23682,114630
080102,Cusco,Cusco,Ccorca,186,2018,42,2246
080103,Cusco,Cusco,Poroy,252,1678,506,2436
080104,Cusco,Cusco,San Jerﾃｳnimo,4999,36575,15501,57075
080105,Cusco,Cusco,San Sebastian,9947,73906,28683,112536
080106,Cusco,Cusco,Santiago,8388,70606,15762,94756
080107,Cusco,Cusco,Saylla,594,2897,1877,5368
080108,Cusco,Cusco,Wanchaq,3857,40378,14306,58541
080201,Cusco,Acomayo,Acomayo,367,3881,284,4532
080202,Cusco,Acomayo,Acopia,162,2386,102,2650
080203,Cusco,Acomayo,Acos,167,1918,157,2242
080204,Cusco,Acomayo,Mosoc Llacta,79,977,40,1096
080205,Cusco,Acomayo,Pomacanchi,597,6319,290,7206
080206,Cusco,Acomayo,Rondocan,113,1764,61,1938
080207,Cusco,Acomayo,Sangarara,264,2626,386,3276
080301,Cusco,Anta,Anta,2029,17294,2351,21674
080302,Cusco,Anta,Ancahuasi,600,5782,402,6784
080303,Cusco,Anta,Cachimayo,195,1749,438,2382
080304,Cusco,Anta,Chinchaypujio,346,3486,194,4026
080305,Cusco,Anta,Huarocondo,359,3935,239,4533
080306,Cusco,Anta,Limatambo,574,6172,509,7255
080307,Cusco,Anta,Mollepata,272,2471,368,3111
080308,Cusco,Anta,Pucyura,279,2364,347,2990
080309,Cusco,Anta,Zurite,287,2893,271,3451
080401,Cusco,Calca,Calca,1858,15987,2783,20628
080402,Cusco,Calca,Coya,259,2922,262,3443
080403,Cusco,Calca,Lamay,462,4508,343,5313
080404,Cusco,Calca,Lares,526,5045,182,5753
080405,Cusco,Calca,Pisac,823,8276,785,9884
080406,Cusco,Calca,San Salvador,477,4525,230,5232
080407,Cusco,Calca,Taray,375,3723,214,4312
080408,Cusco,Calca,Yanatile,759,7459,372,8590
080501,Cusco,Canas,Yanaoca,626,7664,369,8659
080502,Cusco,Canas,Checca,395,4548,42,4985
080503,Cusco,Canas,Kunturkanki,375,4239,133,4747
080504,Cusco,Canas,Langui,139,1767,78,1984
080505,Cusco,Canas,Layo,450,4591,130,5171
080506,Cusco,Canas,Pampamarca,102,1628,108,1838
080507,Cusco,Canas,Quehue,200,2340,37,2577
080508,Cusco,Canas,Tupac Amaru,165,2298,60,2523
080601,Cusco,Canchis,Sicuani,4819,47199,5809,57827
080602,Cusco,Canchis,Checacupe,367,4118,235,4720
080603,Cusco,Canchis,Combapata,409,3867,311,4587
080604,Cusco,Canchis,Marangani,670,8592,338,9600
080605,Cusco,Canchis,Pitumarca,699,6101,370,7170
080606,Cusco,Canchis,San Pablo,256,3778,190,4224
080607,Cusco,Canchis,San Pedro,157,2182,278,2617
080608,Cusco,Canchis,Tinta,369,4242,418,5029
080701,Cusco,Chumbivilcas,Santo Tomas,1860,18335,1533,21728
080702,Cusco,Chumbivilcas,Capacmarca,244,3517,105,3866
080703,Cusco,Chumbivilcas,Chamaca,437,5491,316,6244
080704,Cusco,Chumbivilcas,Colquemarca,512,6117,268,6897
080705,Cusco,Chumbivilcas,Livitaca,1132,10311,247,11690
080706,Cusco,Chumbivilcas,Llusco,307,3966,95,4368
080707,Cusco,Chumbivilcas,Quiﾃｱota,311,3369,106,3786
080708,Cusco,Chumbivilcas,Velille,516,6166,1149,7831
080801,Cusco,Espinar,Espinar,3411,25881,5569,34861
080802,Cusco,Espinar,Condoroma,71,709,90,870
080803,Cusco,Espinar,Coporaque,733,8641,253,9627
080804,Cusco,Espinar,Ocoruro,67,918,34,1019
080805,Cusco,Espinar,Pallpata,488,3947,388,4823
080806,Cusco,Espinar,Pichigua,215,2537,53,2805
080807,Cusco,Espinar,Suyckutambo,130,1474,39,1643
080808,Cusco,Espinar,Alto Pichigua,148,1675,111,1934
080901,Cusco,La Convenciﾃｳn,Santa Ana,1295,25236,1468,27999
080902,Cusco,La Convenciﾃｳn,Echarate,1753,19633,1828,23214
080903,Cusco,La Convenciﾃｳn,Huayopata,319,4087,367,4773
080904,Cusco,La Convenciﾃｳn,Maranura,235,3641,258,4134
080905,Cusco,La Convenciﾃｳn,Ocobamba,350,3800,177,4327
080906,Cusco,La Convenciﾃｳn,Quellouno,957,12088,266,13311
080907,Cusco,La Convenciﾃｳn,Kimbiri,1754,12735,1473,15962
080908,Cusco,La Convenciﾃｳn,Santa Teresa,448,5035,489,5972
080909,Cusco,La Convenciﾃｳn,Vilcabamba,658,8617,282,9557
080910,Cusco,La Convenciﾃｳn,Pichari,2351,15610,4730,22691
080911,Cusco,La Convenciﾃｳn,Inkawasi,422,3639,224,4285
080912,Cusco,La Convenciﾃｳn,Villa Virgen,186,1498,296,1980
080913,Cusco,La Convenciﾃｳn,Villa Kintiarina,263,1593,118,1974
080914,Cusco,La Convenciﾃｳn,Megantoni,706,4948,1315,6969
081001,Cusco,Paruro,Paruro,240,2549,416,3205
081002,Cusco,Paruro,Accha,208,2677,143,3028
081003,Cusco,Paruro,Ccapi,180,2850,49,3079
081004,Cusco,Paruro,Colcha,62,868,33,963
081005,Cusco,Paruro,Huanoquite,386,4321,160,4867
081006,Cusco,Paruro,Omacha,524,4845,74,5443
081007,Cusco,Paruro,Paccaritambo,102,1805,125,2032
081008,Cusco,Paruro,Pillpinto,49,880,97,1026
081009,Cusco,Paruro,Yaurisque,167,1717,40,1924
081101,Cusco,Paucartambo,Paucartambo,1365,10092,414,11871
081102,Cusco,Paucartambo,Caicay,258,2336,122,2716
081103,Cusco,Paucartambo,Challabamba,836,7483,114,8433
081104,Cusco,Paucartambo,Colquepata,813,7244,113,8170
081105,Cusco,Paucartambo,Huancarani,719,5961,231,6911
081106,Cusco,Paucartambo,Kosﾃｱipata,472,3612,319,4403
081201,Cusco,Quispicanchi,Urcos,963,8746,905,10614
081202,Cusco,Quispicanchi,Andahuaylillas,562,4664,571,5797
081203,Cusco,Quispicanchi,Camanti,229,1610,380,2219
081204,Cusco,Quispicanchi,Ccarhuayo,285,2493,85,2863
081205,Cusco,Quispicanchi,Ccatca,1389,11694,212,13295
081206,Cusco,Quispicanchi,Cusipata,356,3713,152,4221
081207,Cusco,Quispicanchi,Huaro,386,3659,460,4505
081208,Cusco,Quispicanchi,Lucre,442,3750,414,4606
081209,Cusco,Quispicanchi,Marcapata,429,3750,128,4307
081210,Cusco,Quispicanchi,Ocongate,1560,13264,399,15223
081211,Cusco,Quispicanchi,Oropesa,927,7110,1407,9444
081212,Cusco,Quispicanchi,Quiquijana,1113,8895,328,10336
081301,Cusco,Urubamba,Urubamba,1778,15688,2616,20082
081302,Cusco,Urubamba,Chinchero,1032,8720,725,10477
081303,Cusco,Urubamba,Huayllabamba,484,4462,553,5499
081304,Cusco,Urubamba,Machupicchu,371,2934,2042,5347
081305,Cusco,Urubamba,Maras,505,5201,240,5946
081306,Cusco,Urubamba,Ollantaytambo,888,8133,1144,10165
081307,Cusco,Urubamba,Yucay,306,2426,491,3223
090101,Huancavelica,Huancavelica,Huancavelica,3481,31878,4417,39776
090102,Huancavelica,Huancavelica,Acobambilla,142,1785,93,2020
090103,Huancavelica,Huancavelica,Acoria,1515,16021,264,17800
090104,Huancavelica,Huancavelica,Conayca,55,730,66,851
090105,Huancavelica,Huancavelica,Cuenca,71,1040,26,1137
090106,Huancavelica,Huancavelica,Huachocolpa,165,1549,161,1875
090107,Huancavelica,Huancavelica,Huayllahuara,26,586,25,637
090108,Huancavelica,Huancavelica,Izcuchaca,64,670,112,846
090109,Huancavelica,Huancavelica,Laria,45,693,8,746
090110,Huancavelica,Huancavelica,Manta,78,844,31,953
090111,Huancavelica,Huancavelica,Mariscal Cﾃ｡ceres,48,413,48,509
090112,Huancavelica,Huancavelica,Moya,43,847,92,982
090113,Huancavelica,Huancavelica,Nuevo Occoro,122,1515,49,1686
090114,Huancavelica,Huancavelica,Palca,116,1831,58,2005
090115,Huancavelica,Huancavelica,Pilchaca,42,430,28,500
090116,Huancavelica,Huancavelica,Vilca,145,1700,46,1891
090117,Huancavelica,Huancavelica,Yauli,2294,16760,183,19237
090118,Huancavelica,Huancavelica,Ascensiﾃｳn,1256,12284,2026,15566
090119,Huancavelica,Huancavelica,Huando,497,5298,242,6037
090201,Huancavelica,Acobamba,Acobamba,805,7360,815,8980
090202,Huancavelica,Acobamba,Andabamba,325,2835,63,3223
090203,Huancavelica,Acobamba,Anta,449,4033,58,4540
090204,Huancavelica,Acobamba,Caja,122,1654,66,1842
090205,Huancavelica,Acobamba,Marcas,104,1325,100,1529
090206,Huancavelica,Acobamba,Paucara,1138,8693,584,10415
090207,Huancavelica,Acobamba,Pomacocha,230,2460,139,2829
090208,Huancavelica,Acobamba,Rosario,404,4368,78,4850
090301,Huancavelica,Angaraes,Lircay,2299,19174,1518,22991
090302,Huancavelica,Angaraes,Anchonga,802,6270,43,7115
090303,Huancavelica,Angaraes,Callanmarca,61,546,18,625
090304,Huancavelica,Angaraes,Ccochaccasa,388,2410,158,2956
090305,Huancavelica,Angaraes,Chincho,75,816,52,943
090306,Huancavelica,Angaraes,Congalla,330,3094,120,3544
090307,Huancavelica,Angaraes,Huanca-Huanca,151,1136,50,1337
090308,Huancavelica,Angaraes,Huayllay Grande,75,987,49,1111
090309,Huancavelica,Angaraes,Julcamarca,146,1365,225,1736
090310,Huancavelica,Angaraes,San Antonio de Antaparco,138,2168,17,2323
090311,Huancavelica,Angaraes,Santo Tomas de Pata,122,1286,28,1436
090312,Huancavelica,Angaraes,Secclla,278,2733,79,3090
090401,Huancavelica,Castrovirreyna,Castrovirreyna,300,2446,183,2929
090402,Huancavelica,Castrovirreyna,Arma,63,826,88,977
090403,Huancavelica,Castrovirreyna,Aurahua,164,1283,21,1468
090404,Huancavelica,Castrovirreyna,Capillas,65,790,48,903
090405,Huancavelica,Castrovirreyna,Chupamarca,84,771,33,888
090406,Huancavelica,Castrovirreyna,Cocas,61,613,29,703
090407,Huancavelica,Castrovirreyna,Huachos,60,794,65,919
090408,Huancavelica,Castrovirreyna,Huamatambo,30,323,35,388
090409,Huancavelica,Castrovirreyna,Mollepampa,95,1014,33,1142
090410,Huancavelica,Castrovirreyna,San Juan,46,561,66,673
090411,Huancavelica,Castrovirreyna,Santa Ana,77,593,193,863
090412,Huancavelica,Castrovirreyna,Tantara,66,520,62,648
090413,Huancavelica,Castrovirreyna,Ticrapo,127,1180,174,1481
090501,Huancavelica,Churcampa,Churcampa,430,4309,349,5088
090502,Huancavelica,Churcampa,Anco,561,4576,231,5368
090503,Huancavelica,Churcampa,Chinchihuasi,185,1721,73,1979
090504,Huancavelica,Churcampa,El Carmen,241,2121,67,2429
090505,Huancavelica,Churcampa,La Merced,86,939,53,1078
090506,Huancavelica,Churcampa,Locroja,292,3030,50,3372
090507,Huancavelica,Churcampa,Paucarbamba,408,3764,174,4346
090508,Huancavelica,Churcampa,San Miguel de Mayocc,61,575,109,745
090509,Huancavelica,Churcampa,San Pedro de Coris,263,2669,513,3445
090510,Huancavelica,Churcampa,Pachamarca,171,1639,46,1856
090511,Huancavelica,Churcampa,Cosme,300,2470,62,2832
090601,Huancavelica,Huaytarﾃ｡,Huaytarﾃ｡,175,1677,294,2146
090602,Huancavelica,Huaytarﾃ｡,Ayavi,49,672,24,745
090603,Huancavelica,Huaytarﾃ｡,Cordova,67,818,120,1005
090604,Huancavelica,Huaytarﾃ｡,Huayacundo Arma,30,401,17,448
090605,Huancavelica,Huaytarﾃ｡,Laramarca,65,751,29,845
090606,Huancavelica,Huaytarﾃ｡,Ocoyo,57,652,103,812
090607,Huancavelica,Huaytarﾃ｡,Pilpichaca,273,2398,87,2758
090608,Huancavelica,Huaytarﾃ｡,Querco,60,932,40,1032
090609,Huancavelica,Huaytarﾃ｡,Quito-Arma,59,596,31,686
090610,Huancavelica,Huaytarﾃ｡,San Antonio de Cusicancha,159,1176,23,1358
090611,Huancavelica,Huaytarﾃ｡,San Francisco de Sangayaico,70,776,74,920
090612,Huancavelica,Huaytarﾃ｡,San Isidro,71,969,14,1054
090613,Huancavelica,Huaytarﾃ｡,Santiago de Chocorvos,119,1497,55,1671
090614,Huancavelica,Huaytarﾃ｡,Santiago de Quirahuara,19,349,8,376
090615,Huancavelica,Huaytarﾃ｡,Santo Domingo de Capillas,63,639,22,724
090616,Huancavelica,Huaytarﾃ｡,Tambo,41,600,26,667
090701,Huancavelica,Tayacaja,Pampas,898,7951,1212,10061
090702,Huancavelica,Tayacaja,Acostambo,248,2862,156,3266
090703,Huancavelica,Tayacaja,Acraquia,291,3090,141,3522
090704,Huancavelica,Tayacaja,Ahuaycha,340,3395,138,3873
090705,Huancavelica,Tayacaja,Colcabamba,1041,9515,512,11068
090706,Huancavelica,Tayacaja,Daniel Hernﾃ｡ndez,845,7234,1010,9089
090707,Huancavelica,Tayacaja,Huachocolpa,263,2802,153,3218
090709,Huancavelica,Tayacaja,Huaribamba,225,2709,69,3003
090710,Huancavelica,Tayacaja,ﾃ疎huimpuquio,118,1303,59,1480
090711,Huancavelica,Tayacaja,Pazos,466,4557,136,5159
090713,Huancavelica,Tayacaja,Quishuar,54,652,25,731
090714,Huancavelica,Tayacaja,Salcabamba,387,3317,124,3828
090715,Huancavelica,Tayacaja,Salcahuasi,199,2376,41,2616
090716,Huancavelica,Tayacaja,San Marcos de Rocchac,135,1635,43,1813
090717,Huancavelica,Tayacaja,Surcubamba,389,4021,191,4601
090718,Huancavelica,Tayacaja,Tintay Puncu,307,2479,224,3010
090719,Huancavelica,Tayacaja,Quichuas,447,3331,167,3945
090720,Huancavelica,Tayacaja,Andaymarca,252,1892,229,2373
090721,Huancavelica,Tayacaja,Roble,175,994,131,1300
090722,Huancavelica,Tayacaja,Pichos,236,1608,70,1914
090723,Huancavelica,Tayacaja,Santiago de Tucuma,139,1355,39,1533
100101,Huﾃ｡nuco,Huﾃ｡nuco,Huﾃ｡nuco,7538,69351,12613,89502
100102,Huﾃ｡nuco,Huﾃ｡nuco,Amarilis,7170,61539,12752,81461
100103,Huﾃ｡nuco,Huﾃ｡nuco,Chinchao,1268,11475,392,13135
100104,Huﾃ｡nuco,Huﾃ｡nuco,Churubamba,1626,13875,169,15670
100105,Huﾃ｡nuco,Huﾃ｡nuco,Margos,347,3943,74,4364
100106,Huﾃ｡nuco,Huﾃ｡nuco,Quisqui (Kichki),271,3128,54,3453
100107,Huﾃ｡nuco,Huﾃ｡nuco,San Francisco de Cayran,454,3907,427,4788
100108,Huﾃ｡nuco,Huﾃ｡nuco,San Pedro de Chaulan,349,2374,66,2789
100109,Huﾃ｡nuco,Huﾃ｡nuco,Santa Maria del Valle,1764,16665,797,19226
100110,Huﾃ｡nuco,Huﾃ｡nuco,Yarumayo,136,1382,27,1545
100111,Huﾃ｡nuco,Huﾃ｡nuco,Pillco Marca,3824,28690,11304,43818
100112,Huﾃ｡nuco,Huﾃ｡nuco,Yacus,389,4893,14,5296
100113,Huﾃ｡nuco,Huﾃ｡nuco,San Pablo de Pillao,908,7227,215,8350
100201,Huﾃ｡nuco,Ambo,Ambo,2133,16444,2309,20886
100202,Huﾃ｡nuco,Ambo,Cayna,265,2194,43,2502
100203,Huﾃ｡nuco,Ambo,Colpas,183,1514,34,1731
100204,Huﾃ｡nuco,Ambo,Conchamarca,406,3641,394,4441
100205,Huﾃ｡nuco,Ambo,Huacar,615,6618,216,7449
100206,Huﾃ｡nuco,Ambo,San Francisco,147,1360,54,1561
100207,Huﾃ｡nuco,Ambo,San Rafael,901,7737,290,8928
100208,Huﾃ｡nuco,Ambo,Tomay Kichwa,271,2832,279,3382
100301,Huﾃ｡nuco,Dos de Mayo,La Uniﾃｳn,621,5345,668,6634
100307,Huﾃ｡nuco,Dos de Mayo,Chuquis,261,3056,47,3364
100311,Huﾃ｡nuco,Dos de Mayo,Marﾃｭas,631,4816,124,5571
100313,Huﾃ｡nuco,Dos de Mayo,Pachas,477,4799,117,5393
100316,Huﾃ｡nuco,Dos de Mayo,Quivilla,112,989,127,1228
100317,Huﾃ｡nuco,Dos de Mayo,Ripan,549,4462,309,5320
100321,Huﾃ｡nuco,Dos de Mayo,Shunqui,148,1513,35,1696
100322,Huﾃ｡nuco,Dos de Mayo,Sillapata,161,1622,31,1814
100323,Huﾃ｡nuco,Dos de Mayo,Yanas,169,2023,46,2238
100401,Huﾃ｡nuco,Huacaybamba,Huacaybamba,594,4954,320,5868
100402,Huﾃ｡nuco,Huacaybamba,Canchabamba,274,2392,52,2718
100403,Huﾃ｡nuco,Huacaybamba,Cochabamba,141,1316,119,1576
100404,Huﾃ｡nuco,Huacaybamba,Pinra,588,5727,74,6389
100501,Huﾃ｡nuco,Huamalﾃｭes,Llata,1221,11308,874,13403
100502,Huﾃ｡nuco,Huamalﾃｭes,Arancay,110,1157,89,1356
100503,Huﾃ｡nuco,Huamalﾃｭes,Chavﾃｭn de Pariarca,420,3178,195,3793
100504,Huﾃ｡nuco,Huamalﾃｭes,Jacas Grande,572,4908,123,5603
100505,Huﾃ｡nuco,Huamalﾃｭes,Jircan,184,1168,60,1412
100506,Huﾃ｡nuco,Huamalﾃｭes,Miraflores,342,2710,75,3127
100507,Huﾃ｡nuco,Huamalﾃｭes,Monzﾃｳn,1056,10517,795,12368
100508,Huﾃ｡nuco,Huamalﾃｭes,Punchao,193,1746,70,2009
100509,Huﾃ｡nuco,Huamalﾃｭes,Puﾃｱos,402,3598,62,4062
100510,Huﾃ｡nuco,Huamalﾃｭes,Singa,273,2744,112,3129
100511,Huﾃ｡nuco,Huamalﾃｭes,Tantamayo,177,1543,57,1777
100601,Huﾃ｡nuco,Leoncio Prado,Rupa-Rupa,4210,41663,7193,53066
100602,Huﾃ｡nuco,Leoncio Prado,Daniel Alomﾃｭa Robles,625,5111,406,6142
100603,Huﾃ｡nuco,Leoncio Prado,Hermﾃｭlio Valdizan,367,2891,217,3475
100604,Huﾃ｡nuco,Leoncio Prado,Josﾃｩ Crespo y Castillo,2153,17307,2689,22149
100605,Huﾃ｡nuco,Leoncio Prado,Luyando,855,6977,1119,8951
100606,Huﾃ｡nuco,Leoncio Prado,Mariano Damaso Beraun,1044,8209,795,10048
100607,Huﾃ｡nuco,Leoncio Prado,Pucayacu,405,2430,889,3724
100608,Huﾃ｡nuco,Leoncio Prado,Castillo Grande,1289,9345,2934,13568
100609,Huﾃ｡nuco,Leoncio Prado,Pueblo Nuevo,401,3363,379,4143
100610,Huﾃ｡nuco,Leoncio Prado,Santo Domingo de Anda,255,2055,217,2527
100701,Huﾃ｡nuco,Maraﾃｱﾃｳn,Huacrachuco,1458,12233,459,14150
100702,Huﾃ｡nuco,Maraﾃｱﾃｳn,Cholon,603,4076,693,5372
100703,Huﾃ｡nuco,Maraﾃｱﾃｳn,San Buenaventura,254,1816,41,2111
100704,Huﾃ｡nuco,Maraﾃｱﾃｳn,La Morada,317,1876,597,2790
100705,Huﾃ｡nuco,Maraﾃｱﾃｳn,Santa Rosa de Alto Yanajanca,238,1233,728,2199
100801,Huﾃ｡nuco,Pachitea,Panao,2009,14846,594,17449
100802,Huﾃ｡nuco,Pachitea,Chaglla,1058,8424,621,10103
100803,Huﾃ｡nuco,Pachitea,Molino,1107,9079,366,10552
100804,Huﾃ｡nuco,Pachitea,Umari,1120,9736,199,11055
100901,Huﾃ｡nuco,Puerto Inca,Puerto Inca,1180,6945,1282,9407
100902,Huﾃ｡nuco,Puerto Inca,Codo del Pozuzo,849,5467,785,7101
100903,Huﾃ｡nuco,Puerto Inca,Honoria,547,3670,597,4814
100904,Huﾃ｡nuco,Puerto Inca,Tournavista,650,3863,934,5447
100905,Huﾃ｡nuco,Puerto Inca,Yuyapichis,728,4443,598,5769
101001,Huﾃ｡nuco,Lauricocha,Jesﾃｺs,416,3528,249,4193
101002,Huﾃ｡nuco,Lauricocha,Baﾃｱos,173,1647,136,1956
101003,Huﾃ｡nuco,Lauricocha,Jivia,82,891,38,1011
101004,Huﾃ｡nuco,Lauricocha,Queropalca,70,921,18,1009
101005,Huﾃ｡nuco,Lauricocha,Rondos,328,3163,104,3595
101006,Huﾃ｡nuco,Lauricocha,San Francisco de Asﾃｭs,93,1167,36,1296
101007,Huﾃ｡nuco,Lauricocha,San Miguel de Cauri,482,4662,709,5853
101101,Huﾃ｡nuco,Yarowilca,Chavinillo,412,4249,128,4789
101102,Huﾃ｡nuco,Yarowilca,Cahuac,97,1041,18,1156
101103,Huﾃ｡nuco,Yarowilca,Chacabamba,117,975,18,1110
101104,Huﾃ｡nuco,Yarowilca,Aparicio Pomares,437,4268,30,4735
101105,Huﾃ｡nuco,Yarowilca,Jacas Chico,98,971,41,1110
101106,Huﾃ｡nuco,Yarowilca,Obas,278,3479,88,3845
101107,Huﾃ｡nuco,Yarowilca,Pampamarca,107,986,35,1128
101108,Huﾃ｡nuco,Yarowilca,Choras,175,1811,38,2024
110101,Ica,Ica,Ica,10987,118305,20988,150280
110102,Ica,Ica,La Tinguiﾃｱa,3807,30456,5311,39574
110103,Ica,Ica,Los Aquijes,2202,16705,3056,21963
110104,Ica,Ica,Ocucaje,413,3530,449,4392
110105,Ica,Ica,Pachacutec,694,5798,919,7411
110106,Ica,Ica,Parcona,4831,43645,5571,54047
110107,Ica,Ica,Pueblo Nuevo,578,5132,685,6395
110108,Ica,Ica,Salas,2876,18185,4706,25767
110109,Ica,Ica,San Josﾃｩ de Los Molinos,633,5861,493,6987
110110,Ica,Ica,San Juan Bautista,1169,11218,1459,13846
110111,Ica,Ica,Santiago,2600,22687,2358,27645
110112,Ica,Ica,Subtanjalla,2778,19272,5337,27387
110113,Ica,Ica,Tate,443,3819,447,4709
110114,Ica,Ica,Yauca del Rosario,53,1015,48,1116
110201,Ica,Chincha,Chincha Alta,6282,54610,5457,66349
110202,Ica,Chincha,Alto Laran,865,6048,870,7783
110203,Ica,Chincha,Chavin,32,1592,447,2071
110204,Ica,Chincha,Chincha Baja,1287,10875,847,13009
110205,Ica,Chincha,El Carmen,1302,10511,556,12369
110206,Ica,Chincha,Grocio Prado,2633,20467,2194,25294
110207,Ica,Chincha,Pueblo Nuevo,6225,49652,6727,62604
110208,Ica,Chincha,San Juan de Yanac,88,1039,2,1129
110209,Ica,Chincha,San Pedro de Huacarpana,81,886,25,992
110210,Ica,Chincha,Sunampe,3015,23498,2566,29079
110211,Ica,Chincha,Tambo de Mora,521,4451,462,5434
110301,Ica,Nasca,Nasca,2198,22346,3088,27632
110302,Ica,Nasca,Changuillo,160,1634,156,1950
110303,Ica,Nasca,El Ingenio,276,2619,239,3134
110304,Ica,Nasca,Marcona,1286,11610,3085,15981
110305,Ica,Nasca,Vista Alegre,2089,15792,2579,20460
110401,Ica,Palpa,Palpa,663,6337,748,7748
110402,Ica,Palpa,Llipata,147,1301,107,1555
110403,Ica,Palpa,Rﾃｭo Grande,227,2250,181,2658
110404,Ica,Palpa,Santa Cruz,74,780,73,927
110405,Ica,Palpa,Tibillo,38,277,29,344
110501,Ica,Pisco,Pisco,6490,55924,5053,67467
110502,Ica,Pisco,Huancano,87,1068,224,1379
110503,Ica,Pisco,Humay,511,4566,331,5408
110504,Ica,Pisco,Independencia,1363,10800,824,12987
110505,Ica,Pisco,Paracas,688,4644,1815,7147
110506,Ica,Pisco,San Andrﾃｩs,1301,11249,1217,13767
110507,Ica,Pisco,San Clemente,2702,20135,1977,24814
110508,Ica,Pisco,Tupac Amaru Inca,1886,14127,1762,17775
120101,Junﾃｭn,Huancayo,Huancayo,9022,91441,19530,119993
120104,Junﾃｭn,Huancayo,Carhuacallanga,22,465,19,506
120105,Junﾃｭn,Huancayo,Chacapampa,62,841,56,959
120106,Junﾃｭn,Huancayo,Chicche,46,654,41,741
120107,Junﾃｭn,Huancayo,Chilca,7988,70179,13684,91851
120108,Junﾃｭn,Huancayo,Chongos Alto,68,1163,253,1484
120111,Junﾃｭn,Huancayo,Chupuro,143,1646,157,1946
120112,Junﾃｭn,Huancayo,Colca,74,903,40,1017
120113,Junﾃｭn,Huancayo,Cullhuas,102,1208,25,1335
120114,Junﾃｭn,Huancayo,El Tambo,12425,128740,25194,166359
120116,Junﾃｭn,Huancayo,Huacrapuquio,112,1108,146,1366
120117,Junﾃｭn,Huancayo,Hualhuas,448,3645,1158,5251
120119,Junﾃｭn,Huancayo,Huancan,2389,17143,5298,24830
120120,Junﾃｭn,Huancayo,Huasicancha,58,736,35,829
120121,Junﾃｭn,Huancayo,Huayucachi,881,7464,1455,9800
120122,Junﾃｭn,Huancayo,Ingenio,196,2031,149,2376
120124,Junﾃｭn,Huancayo,Pariahuanca,470,4608,52,5130
120125,Junﾃｭn,Huancayo,Pilcomayo,1779,13710,4566,20055
120126,Junﾃｭn,Huancayo,Pucara,356,4083,309,4748
120127,Junﾃｭn,Huancayo,Quichuay,155,1558,139,1852
120128,Junﾃｭn,Huancayo,Quilcas,350,3184,370,3904
120129,Junﾃｭn,Huancayo,San Agustﾃｭn,1443,10717,3121,15281
120130,Junﾃｭn,Huancayo,San Jerﾃｳnimo de Tunan,1029,8625,1947,11601
120132,Junﾃｭn,Huancayo,Saﾃｱo,508,4158,846,5512
120133,Junﾃｭn,Huancayo,Sapallanga,2036,14980,4080,21096
120134,Junﾃｭn,Huancayo,Sicaya,1705,12371,2856,16932
120135,Junﾃｭn,Huancayo,Santo Domingo de Acobamba,599,5420,203,6222
120136,Junﾃｭn,Huancayo,Viques,248,1970,421,2639
120201,Junﾃｭn,Concepciﾃｳn,Concepciﾃｳn,1160,11930,2338,15428
120202,Junﾃｭn,Concepciﾃｳn,Aco,132,1389,121,1642
120203,Junﾃｭn,Concepciﾃｳn,Andamarca,371,3003,128,3502
120204,Junﾃｭn,Concepciﾃｳn,Chambara,225,2231,94,2550
120205,Junﾃｭn,Concepciﾃｳn,Cochas,193,1635,95,1923
120206,Junﾃｭn,Concepciﾃｳn,Comas,486,4683,208,5377
120207,Junﾃｭn,Concepciﾃｳn,Heroﾃｭnas Toledo,77,845,50,972
120208,Junﾃｭn,Concepciﾃｳn,Manzanares,126,1202,150,1478
120209,Junﾃｭn,Concepciﾃｳn,Mariscal Castilla,147,1155,92,1394
120210,Junﾃｭn,Concepciﾃｳn,Matahuasi,476,4373,688,5537
120211,Junﾃｭn,Concepciﾃｳn,Mito,104,1141,137,1382
120212,Junﾃｭn,Concepciﾃｳn,Nueve de Julio,198,1715,374,2287
120213,Junﾃｭn,Concepciﾃｳn,Orcotuna,466,3810,462,4738
120214,Junﾃｭn,Concepciﾃｳn,San Josﾃｩ de Quero,501,4801,96,5398
120215,Junﾃｭn,Concepciﾃｳn,Santa Rosa de Ocopa,146,1592,245,1983
120301,Junﾃｭn,Chanchamayo,Chanchamayo,2153,21417,4220,27790
120302,Junﾃｭn,Chanchamayo,Perene,5151,43558,4165,52874
120303,Junﾃｭn,Chanchamayo,Pichanaqui,3867,31805,3382,39054
120304,Junﾃｭn,Chanchamayo,San Luis de Shuaro,372,3503,282,4157
120305,Junﾃｭn,Chanchamayo,San Ramﾃｳn,2257,20168,3375,25800
120306,Junﾃｭn,Chanchamayo,Vitoc,139,1415,260,1814
120401,Junﾃｭn,Jauja,Jauja,1258,14253,2397,17908
120402,Junﾃｭn,Jauja,Acolla,428,5302,347,6077
120403,Junﾃｭn,Jauja,Apata,351,3601,332,4284
120404,Junﾃｭn,Jauja,Ataura,105,1012,147,1264
120405,Junﾃｭn,Jauja,Canchayllo,149,1332,120,1601
120406,Junﾃｭn,Jauja,Curicaca,140,1158,112,1410
120407,Junﾃｭn,Jauja,El Mantaro,229,2100,269,2598
120408,Junﾃｭn,Jauja,Huamali,131,1320,195,1646
120409,Junﾃｭn,Jauja,Huaripampa,77,797,126,1000
120410,Junﾃｭn,Jauja,Huertas,195,1617,229,2041
120411,Junﾃｭn,Jauja,Janjaillo,35,494,29,558
120412,Junﾃｭn,Jauja,Julcﾃ｡n,67,612,66,745
120413,Junﾃｭn,Jauja,Leonor Ordoﾃｱez,110,1275,168,1553
120414,Junﾃｭn,Jauja,Llocllapampa,84,972,87,1143
120415,Junﾃｭn,Jauja,Marco,95,1285,71,1451
120416,Junﾃｭn,Jauja,Masma,157,1428,147,1732
120417,Junﾃｭn,Jauja,Masma Chicche,60,648,24,732
120418,Junﾃｭn,Jauja,Molinos,152,1329,92,1573
120419,Junﾃｭn,Jauja,Monobamba,140,1295,227,1662
120420,Junﾃｭn,Jauja,Muqui,68,816,133,1017
120421,Junﾃｭn,Jauja,Muquiyauyo,193,1855,287,2335
120422,Junﾃｭn,Jauja,Paca,55,771,66,892
120423,Junﾃｭn,Jauja,Paccha,127,1263,60,1450
120424,Junﾃｭn,Jauja,Pancan,89,1015,122,1226
120425,Junﾃｭn,Jauja,Parco,86,956,111,1153
120426,Junﾃｭn,Jauja,Pomacancha,125,1257,45,1427
120427,Junﾃｭn,Jauja,Ricran,102,1127,67,1296
120428,Junﾃｭn,Jauja,San Lorenzo,226,1976,336,2538
120429,Junﾃｭn,Jauja,San Pedro de Chunan,34,617,51,702
120430,Junﾃｭn,Jauja,Sausa,297,2200,563,3060
120431,Junﾃｭn,Jauja,Sincos,325,3557,174,4056
120432,Junﾃｭn,Jauja,Tunan Marca,92,863,83,1038
120433,Junﾃｭn,Jauja,Yauli,78,928,91,1097
120434,Junﾃｭn,Jauja,Yauyos,775,7071,1146,8992
120501,Junﾃｭn,Junﾃｭn,Junﾃｭn,878,9157,941,10976
120502,Junﾃｭn,Junﾃｭn,Carhuamayo,536,5512,590,6638
120503,Junﾃｭn,Junﾃｭn,Ondores,88,1079,69,1236
120504,Junﾃｭn,Junﾃｭn,Ulcumayo,434,3698,151,4283
120601,Junﾃｭn,Satipo,Satipo,3422,29347,4306,37075
120602,Junﾃｭn,Satipo,Coviriali,641,4648,489,5778
120603,Junﾃｭn,Satipo,Llaylla,475,5864,205,6544
120604,Junﾃｭn,Satipo,Mazamari,4895,28102,2722,35719
120605,Junﾃｭn,Satipo,Pampa Hermosa,377,3153,160,3690
120606,Junﾃｭn,Satipo,Pangoa,6486,44271,3483,54240
120607,Junﾃｭn,Satipo,Rﾃｭo Negro,5202,23789,1660,30651
120608,Junﾃｭn,Satipo,Rﾃｭo Tambo,3661,21236,1139,26036
120609,Junﾃｭn,Satipo,Vizcatan del Ene,511,2678,1063,4252
120701,Junﾃｭn,Tarma,Tarma,3815,39265,4695,47775
120702,Junﾃｭn,Tarma,Acobamba,695,8042,763,9500
120703,Junﾃｭn,Tarma,Huaricolca,167,1634,98,1899
120704,Junﾃｭn,Tarma,Huasahuasi,901,8671,329,9901
120705,Junﾃｭn,Tarma,La Uniﾃｳn,293,2967,254,3514
120706,Junﾃｭn,Tarma,Palca,455,4846,242,5543
120707,Junﾃｭn,Tarma,Palcamayo,267,3001,170,3438
120708,Junﾃｭn,Tarma,San Pedro de Cajas,243,3081,223,3547
120709,Junﾃｭn,Tarma,Tapo,410,3944,119,4473
120801,Junﾃｭn,Yauli,La Oroya,1073,11650,1298,14021
120802,Junﾃｭn,Yauli,Chacapalpa,65,574,48,687
120803,Junﾃｭn,Yauli,Huay-Huay,121,1234,592,1947
120804,Junﾃｭn,Yauli,Marcapomacocha,72,642,121,835
120805,Junﾃｭn,Yauli,Morococha,335,3362,1458,5155
120806,Junﾃｭn,Yauli,Paccha,134,1300,199,1633
120807,Junﾃｭn,Yauli,Santa Bﾃ｡rbara de Carhuacayan,69,694,341,1104
120808,Junﾃｭn,Yauli,Santa Rosa de Sacco,647,7342,988,8977
120809,Junﾃｭn,Yauli,Suitucancha,69,594,27,690
120810,Junﾃｭn,Yauli,Yauli,320,3313,1708,5341
120901,Junﾃｭn,Chupaca,Chupaca,1691,16630,2020,20341
120902,Junﾃｭn,Chupaca,Ahuac,507,5327,433,6267
120903,Junﾃｭn,Chupaca,Chongos Bajo,342,3771,424,4537
120904,Junﾃｭn,Chupaca,Huachac,230,2395,323,2948
120905,Junﾃｭn,Chupaca,Huamancaca Chico,676,5577,2513,8766
120906,Junﾃｭn,Chupaca,San Juan de Iscos,185,1876,167,2228
120907,Junﾃｭn,Chupaca,San Juan de Jarpa,207,2414,37,2658
120908,Junﾃｭn,Chupaca,Tres de Diciembre,267,1702,696,2665
120909,Junﾃｭn,Chupaca,Yanacancha,243,2267,68,2578
130101,La Libertad,Trujillo,Trujillo,21032,254645,39262,314939
130102,La Libertad,Trujillo,El Porvenir,19516,150224,20721,190461
130103,La Libertad,Trujillo,Florencia de Mora,3120,31056,3086,37262
130104,La Libertad,Trujillo,Huanchaco,6001,47597,14811,68409
130105,La Libertad,Trujillo,La Esperanza,17466,151320,20420,189206
130106,La Libertad,Trujillo,Laredo,3355,31139,2712,37206
130107,La Libertad,Trujillo,Moche,3429,29467,4540,37436
130108,La Libertad,Trujillo,Poroto,329,3074,183,3586
130109,La Libertad,Trujillo,Salaverry,1846,13761,3337,18944
130110,La Libertad,Trujillo,Simbal,373,3528,160,4061
130111,La Libertad,Trujillo,Victor Larco Herrera,4982,51318,12206,68506
130201,La Libertad,Ascope,Ascope,510,5570,382,6462
130202,La Libertad,Ascope,Chicama,1343,12809,1115,15267
130203,La Libertad,Ascope,Chocope,724,7906,691,9321
130204,La Libertad,Ascope,Magdalena de Cao,185,2096,182,2463
130205,La Libertad,Ascope,Paijan,2463,21782,1668,25913
130206,La Libertad,Ascope,Razuri,785,7062,817,8664
130207,La Libertad,Ascope,Santiago de Cao,1502,16522,1180,19204
130208,La Libertad,Ascope,Casa Grande,2272,24749,1471,28492
130301,La Libertad,Bolﾃｭvar,Bolﾃｭvar,458,3752,245,4455
130302,La Libertad,Bolﾃｭvar,Bambamarca,370,2469,69,2908
130303,La Libertad,Bolﾃｭvar,Condormarca,230,1598,86,1914
130304,La Libertad,Bolﾃｭvar,Longotea,214,1640,244,2098
130305,La Libertad,Bolﾃｭvar,Uchumarca,238,1882,126,2246
130306,La Libertad,Bolﾃｭvar,Ucuncha,95,675,66,836
130401,La Libertad,Chepﾃｩn,Chepﾃｩn,3478,39321,2934,45733
130402,La Libertad,Chepﾃｩn,Pacanga,1888,16812,2356,21056
130403,La Libertad,Chepﾃｩn,Pueblo Nuevo,989,9933,707,11629
130501,La Libertad,Julcﾃ｡n,Julcﾃ｡n,1181,10115,209,11505
130502,La Libertad,Julcﾃ｡n,Calamarca,458,4358,50,4866
130503,La Libertad,Julcﾃ｡n,Carabamba,731,5422,68,6221
130504,La Libertad,Julcﾃ｡n,Huaso,639,4744,49,5432
130601,La Libertad,Otuzco,Otuzco,2300,21189,680,24169
130602,La Libertad,Otuzco,Agallpampa,1026,8064,162,9252
130604,La Libertad,Otuzco,Charat,209,2129,82,2420
130605,La Libertad,Otuzco,Huaranchal,370,3425,145,3940
130606,La Libertad,Otuzco,La Cuesta,57,530,27,614
130608,La Libertad,Otuzco,Mache,242,2384,67,2693
130610,La Libertad,Otuzco,Paranday,45,466,12,523
130611,La Libertad,Otuzco,Salpo,515,5137,179,5831
130613,La Libertad,Otuzco,Sinsicap,745,6214,73,7032
130614,La Libertad,Otuzco,Usquil,2181,18990,217,21388
130701,La Libertad,Pacasmayo,San Pedro de Lloc,1473,14628,1536,17637
130702,La Libertad,Pacasmayo,Guadalupe,3442,33690,3085,40217
130703,La Libertad,Pacasmayo,Jequetepeque,365,3341,430,4136
130704,La Libertad,Pacasmayo,Pacasmayo,2422,23649,2888,28959
130705,La Libertad,Pacasmayo,San Josﾃｩ,1053,10106,789,11948
130801,La Libertad,Pataz,Tayabamba,1282,10615,593,12490
130802,La Libertad,Pataz,Buldibuyo,389,3020,403,3812
130803,La Libertad,Pataz,Chillia,1441,9991,246,11678
130804,La Libertad,Pataz,Huancaspata,607,5154,116,5877
130805,La Libertad,Pataz,Huaylillas,99,983,76,1158
130806,La Libertad,Pataz,Huayo,378,2948,152,3478
130807,La Libertad,Pataz,Ongon,126,1093,31,1250
130808,La Libertad,Pataz,Parcoy,1680,12484,4566,18730
130809,La Libertad,Pataz,Pataz,1107,6228,1602,8937
130810,La Libertad,Pataz,Pias,152,1323,181,1656
130811,La Libertad,Pataz,Santiago de Challas,173,1988,49,2210
130812,La Libertad,Pataz,Taurija,317,2373,89,2779
130813,La Libertad,Pataz,Urpay,175,1830,43,2048
130901,La Libertad,Sﾃ｡nchez Carriﾃｳn,Huamachuco,7800,54222,4880,66902
130902,La Libertad,Sﾃ｡nchez Carriﾃｳn,Chugay,2153,14273,343,16769
130903,La Libertad,Sﾃ｡nchez Carriﾃｳn,Cochorco,1118,7067,213,8398
130904,La Libertad,Sﾃ｡nchez Carriﾃｳn,Curgos,960,6753,109,7822
130905,La Libertad,Sﾃ｡nchez Carriﾃｳn,Marcabal,1079,9233,119,10431
130906,La Libertad,Sﾃ｡nchez Carriﾃｳn,Sanagoran,1779,10978,165,12922
130907,La Libertad,Sﾃ｡nchez Carriﾃｳn,Sarin,1198,7567,151,8916
130908,La Libertad,Sﾃ｡nchez Carriﾃｳn,Sartimbamba,1566,10467,212,12245
131001,La Libertad,Santiago de Chuco,Santiago de Chuco,1895,15909,507,18311
131002,La Libertad,Santiago de Chuco,Angasmarca,466,4180,164,4810
131003,La Libertad,Santiago de Chuco,Cachicadan,532,4585,202,5319
131004,La Libertad,Santiago de Chuco,Mollebamba,173,1499,62,1734
131005,La Libertad,Santiago de Chuco,Mollepata,223,2078,38,2339
131006,La Libertad,Santiago de Chuco,Quiruvilca,1266,9960,1065,12291
131007,La Libertad,Santiago de Chuco,Santa Cruz de Chuca,235,2414,203,2852
131008,La Libertad,Santiago de Chuco,Sitabamba,385,2753,102,3240
131101,La Libertad,Gran Chimﾃｺ,Cascas,1128,11565,681,13374
131102,La Libertad,Gran Chimﾃｺ,Lucma,415,4128,182,4725
131103,La Libertad,Gran Chimﾃｺ,Marmot,207,1906,294,2407
131104,La Libertad,Gran Chimﾃｺ,Sayapullo,710,5437,239,6386
131201,La Libertad,Virﾃｺ,Virﾃｺ,5636,41987,4784,52407
131202,La Libertad,Virﾃｺ,Chao,3979,22803,6060,32842
131203,La Libertad,Virﾃｺ,Guadalupito,764,5772,539,7075
140101,Lambayeque,Chiclayo,Chiclayo,19768,220584,30144,270496
140102,Lambayeque,Chiclayo,Chongoyape,1562,15356,1446,18364
140103,Lambayeque,Chiclayo,Eten,1121,9896,976,11993
140104,Lambayeque,Chiclayo,Eten Puerto,150,1932,260,2342
140105,Lambayeque,Chiclayo,Josﾃｩ Leonardo Ortiz,12590,128839,15069,156498
140106,Lambayeque,Chiclayo,La Victoria,7762,71774,11376,90912
140107,Lambayeque,Chiclayo,Lagunas,1002,7912,1072,9986
140108,Lambayeque,Chiclayo,Monsefu,2792,27404,2029,32225
140109,Lambayeque,Chiclayo,Nueva Arica,176,2069,213,2458
140110,Lambayeque,Chiclayo,Oyotun,640,6963,598,8201
140111,Lambayeque,Chiclayo,Picsi,733,8721,3250,12704
140112,Lambayeque,Chiclayo,Pimentel,4128,31565,8909,44602
140113,Lambayeque,Chiclayo,Reque,1421,11952,2371,15744
140114,Lambayeque,Chiclayo,Santa Rosa,1335,10300,715,12350
140115,Lambayeque,Chiclayo,Saﾃｱa,944,9563,1110,11617
140116,Lambayeque,Chiclayo,Cayalti,1181,12754,874,14809
140117,Lambayeque,Chiclayo,Patapo,1985,19148,1491,22624
140118,Lambayeque,Chiclayo,Pomalca,2141,21356,1770,25267
140119,Lambayeque,Chiclayo,Pucala,679,7335,687,8701
140120,Lambayeque,Chiclayo,Tuman,2340,23622,1820,27782
140201,Lambayeque,Ferreﾃｱafe,Ferreﾃｱafe,2995,28053,3181,34229
140202,Lambayeque,Ferreﾃｱafe,Caﾃｱaris,1451,9861,54,11366
140203,Lambayeque,Ferreﾃｱafe,Incahuasi,1746,11961,151,13858
140204,Lambayeque,Ferreﾃｱafe,Manuel Antonio Mesones Muro,388,3191,229,3808
140205,Lambayeque,Ferreﾃｱafe,Pitipo,1906,16362,1383,19651
140206,Lambayeque,Ferreﾃｱafe,Pueblo Nuevo,1498,11749,1256,14503
140301,Lambayeque,Lambayeque,Lambayeque,6895,57092,7438,71425
140302,Lambayeque,Lambayeque,Chochope,170,1065,172,1407
140303,Lambayeque,Lambayeque,Illimo,838,7494,524,8856
140304,Lambayeque,Lambayeque,Jayanca,1904,13741,1559,17204
140305,Lambayeque,Lambayeque,Mochumi,1892,15712,797,18401
140306,Lambayeque,Lambayeque,Morrope,6478,40751,980,48209
140307,Lambayeque,Lambayeque,Motupe,3098,24137,2601,29836
140308,Lambayeque,Lambayeque,Olmos,4973,37876,3635,46484
140309,Lambayeque,Lambayeque,Pacora,856,6663,541,8060
140310,Lambayeque,Lambayeque,Salas,1363,10841,391,12595
140311,Lambayeque,Lambayeque,San Josﾃｩ,1892,12705,1249,15846
140312,Lambayeque,Lambayeque,Tucume,2348,18482,1017,21847
150101,Lima,Lima,Lima,15462,209257,43633,268352
150102,Lima,Lima,Ancﾃｳn,5886,40267,16775,62928
150103,Lima,Lima,Ate,49355,460205,89636,599196
150104,Lima,Lima,Barranco,1675,24646,8057,34378
150105,Lima,Lima,Breﾃｱa,4722,62075,18512,85309
150106,Lima,Lima,Carabayllo,30002,234461,68582,333045
150107,Lima,Lima,Chaclacayo,2842,34149,5921,42912
150108,Lima,Lima,Chorrillos,21091,247242,45908,314241
150109,Lima,Lima,Cieneguilla,3265,22942,8477,34684
150110,Lima,Lima,Comas,38827,420231,61392,520450
150111,Lima,Lima,El Agustino,15314,154152,29396,198862
150112,Lima,Lima,Independencia,15001,173013,23346,211360
150113,Lima,Lima,Jesﾃｺs Marﾃｭa,3379,50904,21076,75359
150114,Lima,Lima,La Molina,6606,107420,26653,140679
150115,Lima,Lima,La Victoria,10959,136570,26101,173630
150116,Lima,Lima,Lince,2623,38793,13295,54711
150117,Lima,Lima,Los Olivos,21912,250895,53077,325884
150118,Lima,Lima,Lurigancho,20992,175805,44017,240814
150119,Lima,Lima,Lurin,8108,63493,17594,89195
150120,Lima,Lima,Magdalena del Mar,3089,40132,17069,60290
150121,Lima,Lima,Pueblo Libre,3772,57738,21813,83323
150122,Lima,Lima,Miraflores,4678,64600,30059,99337
150123,Lima,Lima,Pachacamac,10712,78730,20629,110071
150124,Lima,Lima,Pucusana,1395,11110,2386,14891
150125,Lima,Lima,Puente Piedra,29953,239961,59761,329675
150126,Lima,Lima,Punta Hermosa,1386,9068,5420,15874
150127,Lima,Lima,Punta Negra,574,4964,1536,7074
150128,Lima,Lima,Rﾃｭmac,11420,143534,19831,174785
150129,Lima,Lima,San Bartolo,562,5208,1712,7482
150130,Lima,Lima,San Borja,5277,82510,25460,113247
150131,Lima,Lima,San Isidro,2691,39961,18083,60735
150132,Lima,Lima,San Juan de Lurigancho,83236,834315,120944,1038495
150133,Lima,Lima,San Juan de Miraflores,23949,293027,38243,355219
150134,Lima,Lima,San Luis,2852,38835,10395,52082
150135,Lima,Lima,San Martﾃｭn de Porres,45356,499826,108901,654083
150136,Lima,Lima,San Miguel,8531,108001,38852,155384
150137,Lima,Lima,Santa Anita,14702,148160,33352,196214
150138,Lima,Lima,Santa Marﾃｭa del Mar,70,721,208,999
150139,Lima,Lima,Santa Rosa,2922,16801,8140,27863
150140,Lima,Lima,Santiago de Surco,16708,245682,66762,329152
150141,Lima,Lima,Surquillo,4758,65165,21100,91023
150142,Lima,Lima,Villa el Salvador,30365,325938,36951,393254
150143,Lima,Lima,Villa Marﾃｭa del Triunfo,31122,327101,40210,398433
150201,Lima,Barranca,Barranca,5623,56056,6645,68324
150202,Lima,Barranca,Paramonga,1543,18457,1453,21453
150203,Lima,Barranca,Pativilca,1593,14400,1438,17431
150204,Lima,Barranca,Supe,2309,19268,2741,24318
150205,Lima,Barranca,Supe Puerto,1142,9986,1727,12855
150301,Lima,Cajatambo,Cajatambo,132,1773,177,2082
150302,Lima,Cajatambo,Copa,68,758,32,858
150303,Lima,Cajatambo,Gorgor,167,1434,71,1672
150304,Lima,Cajatambo,Huancapon,59,862,63,984
150305,Lima,Cajatambo,Manas,69,805,89,963
150401,Lima,Canta,Canta,155,1976,254,2385
150402,Lima,Canta,Arahuay,29,501,66,596
150403,Lima,Canta,Huamantanga,39,558,89,686
150404,Lima,Canta,Huaros,63,641,56,760
150405,Lima,Canta,Lachaqui,29,772,55,856
150406,Lima,Canta,San Buenaventura,27,488,40,555
150407,Lima,Canta,Santa Rosa de Quives,509,4588,613,5710
150501,Lima,Caﾃｱete,San Vicente de Caﾃｱete,4722,43326,6727,54775
150502,Lima,Caﾃｱete,Asia,1060,7605,1119,9784
150503,Lima,Caﾃｱete,Calango,160,1916,193,2269
150504,Lima,Caﾃｱete,Cerro Azul,821,6468,1039,8328
150505,Lima,Caﾃｱete,Chilca,2097,16200,3276,21573
150506,Lima,Caﾃｱete,Coayllo,77,817,149,1043
150507,Lima,Caﾃｱete,Imperial,3679,32331,2915,38925
150508,Lima,Caﾃｱete,Lunahuana,254,3651,488,4393
150509,Lima,Caﾃｱete,Mala,2928,26762,3027,32717
150510,Lima,Caﾃｱete,Nuevo Imperial,2391,20309,3533,26233
150511,Lima,Caﾃｱete,Pacaran,158,1369,159,1686
150512,Lima,Caﾃｱete,Quilmana,1710,12784,1597,16091
150513,Lima,Caﾃｱete,San Antonio,366,3372,605,4343
150514,Lima,Caﾃｱete,San Luis,1232,11002,1202,13436
150515,Lima,Caﾃｱete,Santa Cruz de Flores,264,2454,385,3103
150516,Lima,Caﾃｱete,Zﾃｺﾃｱiga,97,1052,165,1314
150601,Lima,Huaral,Huaral,7945,84444,7526,99915
150602,Lima,Huaral,Atavillos Alto,38,586,63,687
150603,Lima,Huaral,Atavillos Bajo,40,746,116,902
150604,Lima,Huaral,Aucallama,1402,15809,2253,19464
150605,Lima,Huaral,Chancay,5025,46846,5049,56920
150606,Lima,Huaral,Ihuari,140,1814,83,2037
150607,Lima,Huaral,Lampian,17,277,42,336
150608,Lima,Huaral,Pacaraos,63,860,105,1028
150609,Lima,Huaral,San Miguel de Acos,36,475,137,648
150610,Lima,Huaral,Santa Cruz de Andamarca,19,604,207,830
150611,Lima,Huaral,Sumbilca,25,630,65,720
150612,Lima,Huaral,Veintisiete de Noviembre,18,337,56,411
150701,Lima,Huarochirﾃｭ,Matucana,315,3490,253,4058
150702,Lima,Huarochirﾃｭ,Antioquia,98,995,132,1225
150703,Lima,Huarochirﾃｭ,Callahuanca,50,668,80,798
150704,Lima,Huarochirﾃｭ,Carampoma,23,272,36,331
150705,Lima,Huarochirﾃｭ,Chicla,327,2795,704,3826
150706,Lima,Huarochirﾃｭ,Cuenca,33,375,41,449
150707,Lima,Huarochirﾃｭ,Huachupampa,35,443,131,609
150708,Lima,Huarochirﾃｭ,Huanza,47,603,225,875
150709,Lima,Huarochirﾃｭ,Huarochirﾃｭ,105,1095,102,1302
150710,Lima,Huarochirﾃｭ,Lahuaytambo,41,542,33,616
150711,Lima,Huarochirﾃｭ,Langa,65,742,82,889
150712,Lima,Huarochirﾃｭ,San Pedro de Laraos,28,584,54,666
150713,Lima,Huarochirﾃｭ,Mariatana,136,1181,40,1357
150714,Lima,Huarochirﾃｭ,Ricardo Palma,485,5155,902,6542
150715,Lima,Huarochirﾃｭ,San Andrﾃｩs de Tupicocha,155,1149,16,1320
150716,Lima,Huarochirﾃｭ,San Antonio,44,699,169,912
150717,Lima,Huarochirﾃｭ,San Bartolomﾃｩ,73,946,120,1139
150718,Lima,Huarochirﾃｭ,San Damian,97,1052,53,1202
150719,Lima,Huarochirﾃｭ,San Juan de Iris,47,557,95,699
150720,Lima,Huarochirﾃｭ,San Juan de Tantaranche,36,322,16,374
150721,Lima,Huarochirﾃｭ,San Lorenzo de Quinti,78,1062,83,1223
150722,Lima,Huarochirﾃｭ,San Mateo,348,3591,306,4245
150723,Lima,Huarochirﾃｭ,San Mateo de Otao,92,1193,50,1335
150724,Lima,Huarochirﾃｭ,San Pedro de Casta,44,838,46,928
150725,Lima,Huarochirﾃｭ,San Pedro de Huancayre,14,189,7,210
150726,Lima,Huarochirﾃｭ,Sangallaya,57,485,88,630
150727,Lima,Huarochirﾃｭ,Santa Cruz de Cocachacra,183,1921,382,2486
150728,Lima,Huarochirﾃｭ,Santa Eulalia,1029,10004,1603,12636
150729,Lima,Huarochirﾃｭ,Santiago de Anchucaya,17,276,27,320
150730,Lima,Huarochirﾃｭ,Santiago de Tuna,23,370,18,411
150731,Lima,Huarochirﾃｭ,Santo Domingo de los Olleros,369,2088,668,3125
150732,Lima,Huarochirﾃｭ,Surco,92,1199,116,1407
150801,Lima,Huaura,Huacho,4793,49971,8378,63142
150802,Lima,Huaura,Ambar,196,1942,70,2208
150803,Lima,Huaura,Caleta de Carquin,575,5835,1722,8132
150804,Lima,Huaura,Checras,42,847,40,929
150805,Lima,Huaura,Hualmay,2360,22894,3511,28765
150806,Lima,Huaura,Huaura,3170,28010,3584,34764
150807,Lima,Huaura,Leoncio Prado,151,1631,85,1867
150808,Lima,Huaura,Paccho,110,1342,64,1516
150809,Lima,Huaura,Santa Leonor,52,675,48,775
150810,Lima,Huaura,Santa Marﾃｭa,3252,27091,5924,36267
150811,Lima,Huaura,Sayan,2137,18822,2449,23408
150812,Lima,Huaura,Vegueta,2711,19029,4172,25912
150901,Lima,Oyﾃｳn,Oyﾃｳn,1055,8971,2124,12150
150902,Lima,Oyﾃｳn,Andajes,22,477,47,546
150903,Lima,Oyﾃｳn,Caujul,57,476,43,576
150904,Lima,Oyﾃｳn,Cochamarca,90,961,35,1086
150905,Lima,Oyﾃｳn,Navan,61,740,54,855
150906,Lima,Oyﾃｳn,Pachangara,171,2005,350,2526
151001,Lima,Yauyos,Yauyos,102,1253,126,1481
151002,Lima,Yauyos,Alis,20,682,832,1534
151003,Lima,Yauyos,Allauca,95,942,108,1145
151004,Lima,Yauyos,Ayaviri,32,481,52,565
151005,Lima,Yauyos,Azangaro,39,374,27,440
151006,Lima,Yauyos,Cacra,46,416,45,507
151007,Lima,Yauyos,Carania,14,139,9,162
151008,Lima,Yauyos,Catahuasi,83,897,82,1062
151009,Lima,Yauyos,Chocos,72,695,34,801
151010,Lima,Yauyos,Cochas,12,180,24,216
151011,Lima,Yauyos,Colonia,73,1002,34,1109
151012,Lima,Yauyos,Hongos,26,282,23,331
151013,Lima,Yauyos,Huampara,4,115,30,149
151014,Lima,Yauyos,Huancaya,23,428,145,596
151015,Lima,Yauyos,Huangascar,46,507,84,637
151016,Lima,Yauyos,Huantan,60,560,321,941
151017,Lima,Yauyos,Huaﾃｱec,11,351,70,432
151018,Lima,Yauyos,Laraos,37,419,90,546
151019,Lima,Yauyos,Lincha,39,401,7,447
151020,Lima,Yauyos,Madean,54,491,25,570
151021,Lima,Yauyos,Miraflores,14,198,17,229
151022,Lima,Yauyos,Omas,23,528,42,593
151023,Lima,Yauyos,Putinza,38,414,46,498
151024,Lima,Yauyos,Quinches,30,558,21,609
151025,Lima,Yauyos,Quinocay,28,366,34,428
151026,Lima,Yauyos,San Joaquﾃｭn,8,140,18,166
151027,Lima,Yauyos,San Pedro de Pilas,18,244,13,275
151028,Lima,Yauyos,Tanta,21,461,25,507
151029,Lima,Yauyos,Tauripampa,13,450,36,499
151030,Lima,Yauyos,Tomas,36,423,61,520
151031,Lima,Yauyos,Tupe,52,442,39,533
151032,Lima,Yauyos,Viﾃｱac,133,1416,75,1624
151033,Lima,Yauyos,Vitis,9,276,26,311
160101,Loreto,Maynas,Iquitos,10165,124977,11711,146853
160102,Loreto,Maynas,Alto Nanay,355,2385,115,2855
160103,Loreto,Maynas,Fernando Lores,1561,11784,530,13875
160104,Loreto,Maynas,Indiana,1338,8251,545,10134
160105,Loreto,Maynas,Las Amazonas,954,6783,295,8032
160106,Loreto,Maynas,Mazan,1651,10088,442,12181
160107,Loreto,Maynas,Napo,1887,12691,425,15003
160108,Loreto,Maynas,Punchana,7945,58814,8451,75210
160110,Loreto,Maynas,Torres Causana,653,3426,151,4230
160112,Loreto,Maynas,Belﾃｩn,6802,50489,7197,64488
160113,Loreto,Maynas,San Juan Bautista,14257,90994,21754,127005
160201,Loreto,Alto Amazonas,Yurimaguas,9740,64998,8816,83554
160202,Loreto,Alto Amazonas,Balsapuerto,2394,11101,212,13707
160205,Loreto,Alto Amazonas,Jeberos,586,3162,152,3900
160206,Loreto,Alto Amazonas,Lagunas,1531,10023,479,12033
160210,Loreto,Alto Amazonas,Santa Cruz,577,3266,124,3967
160211,Loreto,Alto Amazonas,Teniente Cesar Lﾃｳpez Rojas,720,4375,469,5564
160301,Loreto,Loreto,Nauta,3709,24220,2034,29963
160302,Loreto,Loreto,Parinari,755,5029,301,6085
160303,Loreto,Loreto,Tigre,965,5313,170,6448
160304,Loreto,Loreto,Trompeteros,1355,6669,372,8396
160305,Loreto,Loreto,Urarinas,1678,9605,262,11545
160401,Loreto,Mariscal Ramﾃｳn Castilla,Ramﾃｳn Castilla,2421,15872,885,19178
160402,Loreto,Mariscal Ramﾃｳn Castilla,Pebas,1440,9255,384,11079
160403,Loreto,Mariscal Ramﾃｳn Castilla,Yavari,1152,6819,395,8366
160404,Loreto,Mariscal Ramﾃｳn Castilla,San Pablo,1399,8800,250,10449
160501,Loreto,Requena,Requena,3346,20616,1351,25313
160502,Loreto,Requena,Alto Tapiche,212,1230,73,1515
160503,Loreto,Requena,Capelo,316,2117,133,2566
160504,Loreto,Requena,Emilio San Martﾃｭn,790,5115,184,6089
160505,Loreto,Requena,Maquia,998,6010,296,7304
160506,Loreto,Requena,Puinahua,577,3680,115,4372
160507,Loreto,Requena,Saquena,417,2810,138,3365
160508,Loreto,Requena,Soplin,96,433,40,569
160509,Loreto,Requena,Tapiche,110,708,63,881
160510,Loreto,Requena,Jenaro Herrera,534,3879,195,4608
160511,Loreto,Requena,Yaquerana,261,1598,70,1929
160601,Loreto,Ucayali,Contamana,3021,19187,1675,23883
160602,Loreto,Ucayali,Inahuaya,214,1386,138,1738
160603,Loreto,Ucayali,Padre Mﾃ｡rquez,456,3117,124,3697
160604,Loreto,Ucayali,Pampa Hermosa,700,4371,317,5388
160605,Loreto,Ucayali,Sarayacu,1788,11177,499,13464
160606,Loreto,Ucayali,Vargas Guerra,680,5385,402,6467
160701,Loreto,Datem del Maraﾃｱﾃｳn,Barranca,1589,9837,1316,12742
160702,Loreto,Datem del Maraﾃｱﾃｳn,Cahuapanas,1105,5170,61,6336
160703,Loreto,Datem del Maraﾃｱﾃｳn,Manseriche,1315,6634,472,8421
160704,Loreto,Datem del Maraﾃｱﾃｳn,Morona,615,3432,144,4191
160705,Loreto,Datem del Maraﾃｱﾃｳn,Pastaza,761,4169,148,5078
160706,Loreto,Datem del Maraﾃｱﾃｳn,Andoas,2119,9522,73,11714
160801,Loreto,Putumayo,Putumayo,423,2856,387,3666
160802,Loreto,Putumayo,Rosa Panduro,64,412,44,520
160803,Loreto,Putumayo,Teniente Manuel Clavero,300,1881,136,2317
160804,Loreto,Putumayo,Yaguas,163,960,154,1277
170101,Madre de Dios,Tambopata,Tambopata,7850,62748,11327,81925
170102,Madre de Dios,Tambopata,Inambari,1403,7108,3059,11570
170103,Madre de Dios,Tambopata,Las Piedras,1496,7490,3658,12644
170104,Madre de Dios,Tambopata,Laberinto,579,3877,879,5335
170201,Madre de Dios,Manu,Manu,260,1722,374,2356
170202,Madre de Dios,Manu,Fitzcarrald,230,1048,124,1402
170203,Madre de Dios,Manu,Madre de Dios,721,4096,1400,6217
170204,Madre de Dios,Manu,Huepetuhe,841,5908,1825,8574
170301,Madre de Dios,Tahuamanu,Iﾃｱapari,262,1287,842,2391
170302,Madre de Dios,Tahuamanu,Iberia,550,4229,1012,5791
170303,Madre de Dios,Tahuamanu,Tahuamanu,328,1712,825,2865
180101,Moquegua,Mariscal Nieto,Moquegua,5149,52754,7905,65808
180102,Moquegua,Mariscal Nieto,Carumas,94,2119,153,2366
180103,Moquegua,Mariscal Nieto,Cuchumbaya,30,687,44,761
180104,Moquegua,Mariscal Nieto,Samegua,616,6184,1680,8480
180105,Moquegua,Mariscal Nieto,San Cristﾃｳbal,78,1545,113,1736
180106,Moquegua,Mariscal Nieto,Torata,309,4325,1564,6198
180201,Moquegua,General Sﾃ｡nchez Cerro,Omate,252,2487,419,3158
180202,Moquegua,General Sﾃ｡nchez Cerro,Chojata,56,592,60,708
180203,Moquegua,General Sﾃ｡nchez Cerro,Coalaque,53,816,79,948
180204,Moquegua,General Sﾃ｡nchez Cerro,Ichuﾃｱa,209,2467,225,2901
180205,Moquegua,General Sﾃ｡nchez Cerro,La Capilla,33,553,40,626
180206,Moquegua,General Sﾃ｡nchez Cerro,Lloque,37,494,39,570
180207,Moquegua,General Sﾃ｡nchez Cerro,Matalaque,18,386,51,455
180208,Moquegua,General Sﾃ｡nchez Cerro,Puquina,132,2119,125,2376
180209,Moquegua,General Sﾃ｡nchez Cerro,Quinistaquillas,27,439,52,518
180210,Moquegua,General Sﾃ｡nchez Cerro,Ubinas,87,1528,126,1741
180211,Moquegua,General Sﾃ｡nchez Cerro,Yunga,60,775,29,864
180301,Moquegua,Ilo,Ilo,4998,55810,5671,66479
180302,Moquegua,Ilo,El Algarrobal,508,2241,968,3717
180303,Moquegua,Ilo,Pacocha,278,3340,835,4453
190101,Pasco,Pasco,Chaupimarca,2425,20908,2294,25627
190102,Pasco,Pasco,Huachon,481,3653,199,4333
190103,Pasco,Pasco,Huariaca,677,5633,615,6925
190104,Pasco,Pasco,Huayllay,684,7311,1582,9577
190105,Pasco,Pasco,Ninacaca,379,3296,202,3877
190106,Pasco,Pasco,Pallanchacra,166,1505,67,1738
190107,Pasco,Pasco,Paucartambo,943,9642,631,11216
190108,Pasco,Pasco,San Francisco de Asﾃｭs de Yarusyacan,303,3816,340,4459
190109,Pasco,Pasco,Simon Bolﾃｭvar,1126,10408,1129,12663
190110,Pasco,Pasco,Ticlacayan,298,2861,102,3261
190111,Pasco,Pasco,Tinyahuarco,594,5295,866,6755
190112,Pasco,Pasco,Vicco,269,2471,652,3392
190113,Pasco,Pasco,Yanacancha,2248,23990,2954,29192
190201,Pasco,Daniel Alcides Carriﾃｳn,Yanahuanca,1024,9536,773,11333
190202,Pasco,Daniel Alcides Carriﾃｳn,Chacayan,139,1811,56,2006
190203,Pasco,Daniel Alcides Carriﾃｳn,Goyllarisquizga,111,1400,24,1535
190204,Pasco,Daniel Alcides Carriﾃｳn,Paucar,123,1575,78,1776
190205,Pasco,Daniel Alcides Carriﾃｳn,San Pedro de Pillao,93,1241,14,1348
190206,Pasco,Daniel Alcides Carriﾃｳn,Santa Ana de Tusi,1038,20050,129,21217
190207,Pasco,Daniel Alcides Carriﾃｳn,Tapuc,167,2123,136,2426
190208,Pasco,Daniel Alcides Carriﾃｳn,Vilcabamba,149,1718,72,1939
190301,Pasco,Oxapampa,Oxapampa,1290,11780,2607,15677
190302,Pasco,Oxapampa,Chontabamba,461,3947,926,5334
190303,Pasco,Oxapampa,Huancabamba,714,5395,552,6661
190304,Pasco,Oxapampa,Palcazu,812,5768,550,7130
190305,Pasco,Oxapampa,Pozuzo,443,3642,426,4511
190306,Pasco,Oxapampa,Puerto Bermﾃｺdez,2187,13931,1131,17249
190307,Pasco,Oxapampa,Villa Rica,1604,13769,1901,17274
190308,Pasco,Oxapampa,Constituciﾃｳn,1669,10180,1785,13634
200101,Piura,Piura,Piura,10502,132216,15777,158495
200104,Piura,Piura,Castilla,14384,124777,21040,160201
200105,Piura,Piura,Catacaos,8120,64615,3135,75870
200107,Piura,Piura,Cura Mori,2026,15968,677,18671
200108,Piura,Piura,El Tallan,662,4525,200,5387
200109,Piura,Piura,La Arena,4380,33549,805,38734
200110,Piura,Piura,La Uniﾃｳn,4865,35365,1512,41742
200111,Piura,Piura,Las Lomas,2627,23201,1119,26947
200114,Piura,Piura,Tambo Grande,11616,93810,2069,107495
200115,Piura,Piura,Veintiseis de Octubre,16218,83049,66512,165779
200201,Piura,Ayabaca,Ayabaca,2836,27133,883,30852
200202,Piura,Ayabaca,Frias,2029,17579,288,19896
200203,Piura,Ayabaca,Jilili,235,2102,68,2405
200204,Piura,Ayabaca,Lagunas,731,4907,96,5734
200205,Piura,Ayabaca,Montero,554,5475,150,6179
200206,Piura,Ayabaca,Pacaipampa,2714,18260,283,21257
200207,Piura,Ayabaca,Paimas,1013,8212,396,9621
200208,Piura,Ayabaca,Sapillica,1345,9049,116,10510
200209,Piura,Ayabaca,Sicchez,110,1463,81,1654
200210,Piura,Ayabaca,Suyo,1089,9624,466,11179
200301,Piura,Huancabamba,Huancabamba,2467,23732,1400,27599
200302,Piura,Huancabamba,Canchaque,616,6282,419,7317
200303,Piura,Huancabamba,El Carmen de la Frontera,1142,9915,129,11186
200304,Piura,Huancabamba,Huarmaca,3978,30984,586,35548
200305,Piura,Huancabamba,Lalaquiz,319,3470,82,3871
200306,Piura,Huancabamba,San Miguel de El Faique,913,7487,278,8678
200307,Piura,Huancabamba,Sondor,739,6150,251,7140
200308,Piura,Huancabamba,Sondorillo,1117,8668,377,10162
200401,Piura,Morropﾃｳn,Chulucanas,8183,70871,3467,82521
200402,Piura,Morropﾃｳn,Buenos Aires,811,7873,726,9410
200403,Piura,Morropﾃｳn,Chalaco,673,6845,271,7789
200404,Piura,Morropﾃｳn,La Matanza,1501,11891,605,13997
200405,Piura,Morropﾃｳn,Morropﾃｳn,1301,12946,992,15239
200406,Piura,Morropﾃｳn,Salitral,808,7105,614,8527
200407,Piura,Morropﾃｳn,San Juan de Bigote,576,5571,286,6433
200408,Piura,Morropﾃｳn,Santa Catalina de Mossa,281,3133,236,3650
200409,Piura,Morropﾃｳn,Santo Domingo,353,5362,245,5960
200410,Piura,Morropﾃｳn,Yamango,739,7579,183,8501
200501,Piura,Paita,Paita,9751,73337,4891,87979
200502,Piura,Paita,Amotape,228,2056,129,2413
200503,Piura,Paita,Arenal,93,973,70,1136
200504,Piura,Paita,Colan,1614,12450,805,14869
200505,Piura,Paita,La Huaca,1278,11170,502,12950
200506,Piura,Paita,Tamarindo,475,4173,275,4923
200507,Piura,Paita,Vichayal,689,4716,217,5622
200601,Piura,Sullana,Sullana,15022,144815,9498,169335
200602,Piura,Sullana,Bellavista,3267,32388,1875,37530
200603,Piura,Sullana,Ignacio Escudero,1852,17838,733,20423
200604,Piura,Sullana,Lancones,1078,10821,220,12119
200605,Piura,Sullana,Marcavelica,2738,25728,1103,29569
200606,Piura,Sullana,Miguel Checa,907,7681,448,9036
200607,Piura,Sullana,Querecotillo,2518,22881,996,26395
200608,Piura,Sullana,Salitral,588,6106,353,7047
200701,Piura,Talara,Pariﾃｱas,8865,82012,7432,98309
200702,Piura,Talara,El Alto,784,6978,554,8316
200703,Piura,Talara,La Brea,1052,10702,732,12486
200704,Piura,Talara,Lobitos,128,968,216,1312
200705,Piura,Talara,Los Organos,972,8552,1175,10699
200706,Piura,Talara,Mancora,1250,10232,1546,13028
200801,Piura,Sechura,Sechura,5810,36074,2706,44590
200802,Piura,Sechura,Bellavista de la Uniﾃｳn,536,4045,217,4798
200803,Piura,Sechura,Bernal,784,5778,293,6855
200804,Piura,Sechura,Cristo Nos Valga,514,3501,285,4300
200805,Piura,Sechura,Vice,2083,13163,384,15630
200806,Piura,Sechura,Rinconada Llicuar,331,2536,137,3004
210101,Puno,Puno,Puno,9655,112097,13536,135288
210102,Puno,Puno,Acora,1393,21084,484,22961
210103,Puno,Puno,Amantani,248,3142,62,3452
210104,Puno,Puno,Atuncolla,409,4049,97,4555
210105,Puno,Puno,Capachica,445,6876,219,7540
210106,Puno,Puno,Chucuito,447,6350,222,7019
210107,Puno,Puno,Coata,608,5924,56,6588
210108,Puno,Puno,Huata,269,2784,102,3155
210109,Puno,Puno,Maﾃｱazo,423,4502,219,5144
210110,Puno,Puno,Paucarcolla,292,3837,95,4224
210111,Puno,Puno,Pichacani,401,5101,177,5679
210112,Puno,Puno,Plateria,453,6546,122,7121
210113,Puno,Puno,San Antonio,190,2203,20,2413
210114,Puno,Puno,Tiquillaca,103,1414,77,1594
210115,Puno,Puno,Vilque,235,2462,64,2761
210201,Puno,Azﾃ｡ngaro,Azﾃ｡ngaro,2801,25709,1560,30070
210202,Puno,Azﾃ｡ngaro,Achaya,213,2584,29,2826
210203,Puno,Azﾃ｡ngaro,Arapa,517,6354,149,7020
210204,Puno,Azﾃ｡ngaro,Asillo,1131,13098,255,14484
210205,Puno,Azﾃ｡ngaro,Caminaca,222,2657,52,2931
210206,Puno,Azﾃ｡ngaro,Chupa,422,5966,87,6475
210207,Puno,Azﾃ｡ngaro,Josﾃｩ Domingo Choquehuanca,363,3855,244,4462
210208,Puno,Azﾃ｡ngaro,Muﾃｱani,586,5758,101,6445
210209,Puno,Azﾃ｡ngaro,Potoni,349,3535,55,3939
210210,Puno,Azﾃ｡ngaro,Saman,734,8800,111,9645
210211,Puno,Azﾃ｡ngaro,San Anton,661,6420,217,7298
210212,Puno,Azﾃ｡ngaro,San Josﾃｩ,317,4436,65,4818
210213,Puno,Azﾃ｡ngaro,San Juan de Salinas,207,2592,42,2841
210214,Puno,Azﾃ｡ngaro,Santiago de Pupuja,288,3985,134,4407
210215,Puno,Azﾃ｡ngaro,Tirapata,259,2386,86,2731
210301,Puno,Carabaya,Macusani,1248,10428,988,12664
210302,Puno,Carabaya,Ajoyani,167,1818,153,2138
210303,Puno,Carabaya,Ayapata,630,8407,262,9299
210304,Puno,Carabaya,Coasa,567,5772,94,6433
210305,Puno,Carabaya,Corani,494,3637,109,4240
210306,Puno,Carabaya,Crucero,835,7946,327,9108
210307,Puno,Carabaya,Ituata,527,6845,154,7526
210308,Puno,Carabaya,Ollachea,728,5029,333,6090
210309,Puno,Carabaya,San Gaban,552,5615,665,6832
210310,Puno,Carabaya,Usicayos,664,8205,123,8992
210401,Puno,Chucuito,Juli,1358,17803,612,19773
210402,Puno,Chucuito,Desaguadero,1075,11464,1248,13787
210403,Puno,Chucuito,Huacullani,527,8361,349,9237
210404,Puno,Chucuito,Kelluyo,523,6726,97,7346
210405,Puno,Chucuito,Pisacoma,341,7795,87,8223
210406,Puno,Chucuito,Pomata,866,12506,335,13707
210407,Puno,Chucuito,Zepita,1282,15469,178,16929
210501,Puno,El Collao,Ilave,2887,41449,1682,46018
210502,Puno,El Collao,Capazo,56,1043,31,1130
210503,Puno,El Collao,Pilcuyo,517,10022,133,10672
210504,Puno,El Collao,Santa Rosa,245,3056,228,3529
210505,Puno,El Collao,Conduriri,175,2304,50,2529
210601,Puno,Huancanﾃｩ,Huancanﾃｩ,1239,16641,862,18742
210602,Puno,Huancanﾃｩ,Cojata,321,3326,117,3764
210603,Puno,Huancanﾃｩ,Huatasani,230,2756,97,3083
210604,Puno,Huancanﾃｩ,Inchupalla,150,2367,125,2642
210605,Puno,Huancanﾃｩ,Pusi,347,4483,107,4937
210606,Puno,Huancanﾃｩ,Rosaspata,234,3763,82,4079
210607,Puno,Huancanﾃｩ,Taraco,940,11975,278,13193
210608,Puno,Huancanﾃｩ,Vilque Chico,323,6750,138,7211
210701,Puno,Lampa,Lampa,885,9753,568,11206
210702,Puno,Lampa,Cabanilla,442,4768,142,5352
210703,Puno,Lampa,Calapuja,160,1340,85,1585
210704,Puno,Lampa,Nicasio,202,2099,59,2360
210705,Puno,Lampa,Ocuviri,148,1727,362,2237
210706,Puno,Lampa,Palca,155,1606,56,1817
210707,Puno,Lampa,Paratia,220,2413,99,2732
210708,Puno,Lampa,Pucara,378,4808,120,5306
210709,Puno,Lampa,Santa Lucia,694,5767,567,7028
210710,Puno,Lampa,Vilavila,119,1066,48,1233
210801,Puno,Melgar,Ayaviri,1818,20401,2233,24452
210802,Puno,Melgar,Antauta,398,4034,927,5359
210803,Puno,Melgar,Cupi,156,1741,89,1986
210804,Puno,Melgar,Llalli,214,2220,98,2532
210805,Puno,Melgar,Macari,528,6233,186,6947
210806,Puno,Melgar,Nuﾃｱoa,618,7523,309,8450
210807,Puno,Melgar,Orurillo,562,6938,151,7651
210808,Puno,Melgar,Santa Rosa,454,5461,282,6197
210809,Puno,Melgar,Umachiri,269,3038,257,3564
210901,Puno,Moho  ,Moho,588,10696,234,11518
210902,Puno,Moho  ,Conima,154,2913,84,3151
210903,Puno,Moho  ,Huayrapata,157,2422,34,2613
210904,Puno,Moho  ,Tilali,130,2288,53,2471
211001,Puno,San Antonio de Putina,Putina,1217,12925,611,14753
211002,Puno,San Antonio de Putina,Ananea,669,8156,3790,12615
211003,Puno,San Antonio de Putina,Pedro Vilca Apaza,125,1742,42,1909
211004,Puno,San Antonio de Putina,Quilcapuncu,459,4589,139,5187
211005,Puno,San Antonio de Putina,Sina,160,1347,142,1649
211101,Puno,San Romﾃ｡n,Juliaca,19608,184252,24866,228726
211102,Puno,San Romﾃ｡n,Cabana,369,4333,141,4843
211103,Puno,San Romﾃ｡n,Cabanillas,381,3915,271,4567
211104,Puno,San Romﾃ｡n,Caracoto,551,5741,526,6818
211105,Puno,San Romﾃ｡n,San Miguel,5697,15496,41270,62463
211201,Puno,Sandia,Sandia,781,9111,374,10266
211202,Puno,Sandia,Cuyocuyo,405,4500,119,5024
211203,Puno,Sandia,Limbani,207,2577,186,2970
211204,Puno,Sandia,Patambuco,338,3480,45,3863
211205,Puno,Sandia,Phara,401,4406,284,5091
211206,Puno,Sandia,Quiaca,139,1689,303,2131
211207,Puno,Sandia,San Juan del Oro,252,3264,217,3733
211208,Puno,Sandia,Yanahuaya,155,1670,111,1936
211209,Puno,Sandia,Alto Inambari,554,5679,371,6604
211210,Puno,Sandia,San Pedro de Putina Punco,845,7013,1266,9124
211301,Puno,Yunguyo,Yunguyo,1555,22094,866,24515
211302,Puno,Yunguyo,Anapia,94,1554,134,1782
211303,Puno,Yunguyo,Copani,310,4260,85,4655
211304,Puno,Yunguyo,Cuturapi,62,1176,32,1270
211305,Puno,Yunguyo,Ollaraya,96,2571,44,2711
211306,Puno,Yunguyo,Tinicachi,48,883,18,949
211307,Puno,Yunguyo,Unicachi,46,964,47,1057
220101,San Martﾃｭn,Moyobamba,Moyobamba,7400,59542,9383,76325
220102,San Martﾃｭn,Moyobamba,Calzada,448,3617,544,4609
220103,San Martﾃｭn,Moyobamba,Habana,158,1228,289,1675
220104,San Martﾃｭn,Moyobamba,Jepelacio,1566,13054,757,15377
220105,San Martﾃｭn,Moyobamba,Soritor,2206,17764,1544,21514
220106,San Martﾃｭn,Moyobamba,Yantalo,283,2205,377,2865
220201,San Martﾃｭn,Bellavista,Bellavista,1731,12632,2531,16894
220202,San Martﾃｭn,Bellavista,Alto Biavo,907,5916,816,7639
220203,San Martﾃｭn,Bellavista,Bajo Biavo,1510,10699,907,13116
220204,San Martﾃｭn,Bellavista,Huallaga,282,2107,322,2711
220205,San Martﾃｭn,Bellavista,San Pablo,882,7263,495,8640
220206,San Martﾃｭn,Bellavista,San Rafael,649,4518,866,6033
220301,San Martﾃｭn,El Dorado,San Josﾃｩ de Sisa,1619,11982,1038,14639
220302,San Martﾃｭn,El Dorado,Agua Blanca,218,1981,131,2330
220303,San Martﾃｭn,El Dorado,San Martﾃｭn,1247,8603,597,10447
220304,San Martﾃｭn,El Dorado,Santa Rosa,657,5378,297,6332
220305,San Martﾃｭn,El Dorado,Shatoja,334,2496,174,3004
220401,San Martﾃｭn,Huallaga,Saposoa,1256,10865,1301,13422
220402,San Martﾃｭn,Huallaga,Alto Saposoa,530,3377,564,4471
220403,San Martﾃｭn,Huallaga,El Eslabﾃｳn,206,1712,188,2106
220404,San Martﾃｭn,Huallaga,Piscoyacu,453,3339,476,4268
220405,San Martﾃｭn,Huallaga,Sacanche,216,1980,254,2450
220406,San Martﾃｭn,Huallaga,Tingo de Saposoa,58,649,82,789
220501,San Martﾃｭn,Lamas,Lamas,1236,12085,1176,14497
220502,San Martﾃｭn,Lamas,Alonso de Alvarado,1434,11430,598,13462
220503,San Martﾃｭn,Lamas,Barranquita,675,5109,645,6429
220504,San Martﾃｭn,Lamas,Caynarachi,1146,7232,1168,9546
220505,San Martﾃｭn,Lamas,Cuﾃｱumbuqui,263,2800,238,3301
220506,San Martﾃｭn,Lamas,Pinto Recodo,818,6976,292,8086
220507,San Martﾃｭn,Lamas,Rumisapa,301,2853,302,3456
220508,San Martﾃｭn,Lamas,San Roque de Cumbaza,175,1363,97,1635
220509,San Martﾃｭn,Lamas,Shanao,177,1690,108,1975
220510,San Martﾃｭn,Lamas,Tabalosos,1443,11656,780,13879
220511,San Martﾃｭn,Lamas,Zapatero,563,4331,361,5255
220601,San Martﾃｭn,Mariscal Cﾃ｡ceres,Juanjuﾃｭ,3044,25432,3968,32444
220602,San Martﾃｭn,Mariscal Cﾃ｡ceres,Campanilla,1455,9806,1444,12705
220603,San Martﾃｭn,Mariscal Cﾃ｡ceres,Huicungo,1014,6240,1131,8385
220604,San Martﾃｭn,Mariscal Cﾃ｡ceres,Pachiza,659,4406,682,5747
220605,San Martﾃｭn,Mariscal Cﾃ｡ceres,Pajarillo,589,4233,523,5345
220701,San Martﾃｭn,Picota,Picota,1006,7773,1424,10203
220702,San Martﾃｭn,Picota,Buenos Aires,286,2387,251,2924
220703,San Martﾃｭn,Picota,Caspisapa,199,1663,264,2126
220704,San Martﾃｭn,Picota,Pilluana,79,713,73,865
220705,San Martﾃｭn,Picota,Pucacaca,291,2219,461,2971
220706,San Martﾃｭn,Picota,San Cristﾃｳbal,128,904,160,1192
220707,San Martﾃｭn,Picota,San Hilariﾃｳn,416,2982,547,3945
220708,San Martﾃｭn,Picota,Shamboyacu,1110,6812,632,8554
220709,San Martﾃｭn,Picota,Tingo de Ponasa,388,3094,394,3876
220710,San Martﾃｭn,Picota,Tres Unidos,364,3177,348,3889
220801,San Martﾃｭn,Rioja,Rioja,2439,19971,3111,25521
220802,San Martﾃｭn,Rioja,Awajun,991,5975,513,7479
220803,San Martﾃｭn,Rioja,Elﾃｭas Soplin Vargas,2181,12587,2893,17661
220804,San Martﾃｭn,Rioja,Nueva Cajamarca,4538,33741,5197,43476
220805,San Martﾃｭn,Rioja,Pardo Miguel,1850,13662,1285,16797
220806,San Martﾃｭn,Rioja,Posic,237,1288,394,1919
220807,San Martﾃｭn,Rioja,San Fernando,370,2774,269,3413
220808,San Martﾃｭn,Rioja,Yorongos,240,2057,149,2446
220809,San Martﾃｭn,Rioja,Yuracyacu,358,3118,356,3832
220901,San Martﾃｭn,San Martﾃｭn,Tarapoto,5844,57904,12374,76122
220902,San Martﾃｭn,San Martﾃｭn,Alberto Leveau,75,673,93,841
220903,San Martﾃｭn,San Martﾃｭn,Cacatachi,312,2728,564,3604
220904,San Martﾃｭn,San Martﾃｭn,Chazuta,1174,7734,589,9497
220905,San Martﾃｭn,San Martﾃｭn,Chipurana,306,1647,296,2249
220906,San Martﾃｭn,San Martﾃｭn,El Porvenir,268,1691,440,2399
220907,San Martﾃｭn,San Martﾃｭn,Huimbayoc,644,3838,493,4975
220908,San Martﾃｭn,San Martﾃｭn,Juan Guerra,319,3049,539,3907
220909,San Martﾃｭn,San Martﾃｭn,La Banda de Shilcayo,4163,30637,8681,43481
220910,San Martﾃｭn,San Martﾃｭn,Morales,2711,22284,8072,33067
220911,San Martﾃｭn,San Martﾃｭn,Papaplaya,262,1673,138,2073
220912,San Martﾃｭn,San Martﾃｭn,San Antonio,140,1297,237,1674
220913,San Martﾃｭn,San Martﾃｭn,Sauce,748,5675,840,7263
220914,San Martﾃｭn,San Martﾃｭn,Shapaja,160,1602,181,1943
221001,San Martﾃｭn,Tocache,Tocache,2507,20605,3054,26166
221002,San Martﾃｭn,Tocache,Nuevo Progreso,1212,8425,1819,11456
221003,San Martﾃｭn,Tocache,Polvora,1012,7901,1395,10308
221004,San Martﾃｭn,Tocache,Shunte,174,997,144,1315
221005,San Martﾃｭn,Tocache,Uchiza,2007,15021,3121,20149
230101,Tacna,Tacna,Tacna,5777,73346,13849,92972
230102,Tacna,Tacna,Alto de la Alianza,2177,27809,4075,34061
230103,Tacna,Tacna,Calana,187,2361,431,2979
230104,Tacna,Tacna,Ciudad Nueva,2521,25521,3824,31866
230105,Tacna,Tacna,Inclan,192,2214,207,2613
230106,Tacna,Tacna,Pachia,125,1666,271,2062
230107,Tacna,Tacna,Palca,90,1391,499,1980
230108,Tacna,Tacna,Pocollay,1217,13839,3571,18627
230109,Tacna,Tacna,Sama,212,2525,490,3227
230110,Tacna,Tacna,Coronel Gregorio Albarracin Lanchipa,9442,81292,19683,110417
230111,Tacna,Tacna,La Yarada los Palos,458,4398,703,5559
230201,Tacna,Candarave,Candarave,133,2102,119,2354
230202,Tacna,Candarave,Cairani,52,913,23,988
230203,Tacna,Candarave,Camilaca,66,1030,52,1148
230204,Tacna,Candarave,Curibaya,18,282,77,377
230205,Tacna,Candarave,Huanuara,29,456,30,515
230206,Tacna,Candarave,Quilahuani,47,639,34,720
230301,Tacna,Jorge Basadre,Locumba,187,1810,259,2256
230302,Tacna,Jorge Basadre,Ilabaya,381,3853,1461,5695
230303,Tacna,Jorge Basadre,Ite,180,1853,789,2822
230401,Tacna,Tarata,Tarata,225,2495,922,3642
230402,Tacna,Tarata,Hﾃｩroes Albarracﾃｭn,14,277,15,306
230403,Tacna,Tarata,Estique,11,205,24,240
230404,Tacna,Tarata,Estique-Pampa,6,130,26,162
230405,Tacna,Tarata,Sitajara,10,294,46,350
230406,Tacna,Tarata,Susapaya,16,477,25,518
230407,Tacna,Tarata,Tarucachi,13,270,12,295
230408,Tacna,Tarata,Ticaco,38,515,28,581
240101,Tumbes,Tumbes,Tumbes,9124,85447,7735,102306
240102,Tumbes,Tumbes,Corrales,2347,19471,1519,23337
240103,Tumbes,Tumbes,La Cruz,941,7756,810,9507
240104,Tumbes,Tumbes,Pampas de Hospital,636,5711,381,6728
240105,Tumbes,Tumbes,San Jacinto,735,7308,469,8512
240106,Tumbes,Tumbes,San Juan de la Virgen,426,3800,346,4572
240201,Tumbes,Contralmirante Villar,Zorritos,1219,9836,1316,12371
240202,Tumbes,Contralmirante Villar,Casitas,176,1961,213,2350
240203,Tumbes,Contralmirante Villar,Canoas de Punta Sal,688,4708,940,6336
240301,Tumbes,Zarumilla,Zarumilla,2334,17337,2105,21776
240302,Tumbes,Zarumilla,Aguas Verdes,2000,13681,1685,17366
240303,Tumbes,Zarumilla,Matapalo,410,2252,766,3428
240304,Tumbes,Zarumilla,Papayal,659,4948,667,6274
250101,Ucayali,Coronel Portillo,Calleria,14142,116731,19126,149999
250102,Ucayali,Coronel Portillo,Campoverde,1851,11703,2505,16059
250103,Ucayali,Coronel Portillo,Iparia,1660,8360,308,10328
250104,Ucayali,Coronel Portillo,Masisea,1649,9019,479,11147
250105,Ucayali,Coronel Portillo,Yarinacocha,11268,77909,14764,103941
250106,Ucayali,Coronel Portillo,Nueva Requena,697,3759,713,5169
250107,Ucayali,Coronel Portillo,Manantay,10395,65973,11157,87525
250201,Ucayali,Atalaya,Raymondi,4924,24944,2562,32430
250202,Ucayali,Atalaya,Sepahua,954,5054,647,6655
250203,Ucayali,Atalaya,Tahuania,1317,6561,386,8264
250204,Ucayali,Atalaya,Yurua,334,1520,121,1975
250301,Ucayali,Padre Abad,Padre Abad,3344,22944,3152,29440
250302,Ucayali,Padre Abad,Irazola,1146,7868,1200,10214
250303,Ucayali,Padre Abad,Curimana,941,5432,1349,7722
250304,Ucayali,Padre Abad,Neshuya,933,5221,1440,7594
250305,Ucayali,Padre Abad,Alexander Von Humboldt,559,3849,729,5137
250401,Ucayali,Purﾃｺs,Purﾃｺs,370,2332,158,2860
0TOTAL,,"","",2494300,23286249,3601335,29381884
,,"","",,,,
,,"","",,,,
,,"","",,,,
